CASSLVGGLVGGYTF	GILGFVFTL
CASSFAGGAAGELF	NLVPMVATV
CASTGTDSYEQYF	ALYGFVPVL
CASSYSGHVNTEAFF	GILGFVFTL
CSVEQGAIGYTF	GILGFVFTL
CASSFFLAAGYPF	GILGFVFTL
CASSYSSSTGELFF	NLVPMVATV
CASSLLGRAGTDTQYF	GILGFVFTL
CASSPRSSDTQYF	GILGFVFTL
CASSQERGGKWAYEQYF	NLVPMVATV
CASSQGTSGVNEQLF	ELAGIGILTV
CSVPTSGGSNEQFF	LLWNGPMAV
CSQTNREYNEQF	YVLDHLIVV
CASSIQGNSNQPQHF	RLGPYLEFL
CASSSLGGKNYGYTF	NLVPMVATV
CASSFWREPTYEQYF	NLVPMVATV
CSVQGPYNEQFF	NLNCCSVPV
CASRSEETQYF	NLVPMVATV
CASSLQSLLDEKLF	ELAGIGILTV
CASSFMTEAGELFF	ILNAMIAKI
CSARDFDRTGELF	NLVPMVATV
CASRLKDSDSQPQHF	GILGFVFTL
CAPRRGPTNEKLFF	GILGFVFTL
CSVEVGRAVNTEAFF	GILGFVFTL
CASRPFVNTEAF	NLVPMVATV
CASSYSDRSSYEQYF	NLNCCSVPV
CASSFSGLSNTEAFF	GILGFVFTL
CASSFLNLNNEQFF	GILGFVFTL
CASSFFVGAGVGETQYF	NLVPMVATV
CASTDTGELFF	KLMNIQQKL
CSARPGLAGGYEQYF	ALYGFVPVL
CANSFQGFTEAF	NLVPMVATV
CASSSAGGRDEQFF	GILGFVFTL
CASSLAGGTAHTEAF	NLVPMVATV
CASSILSNTEAFF	GILGFVFTL
CASSLTVYNEQFF	FLTVFSHFM
CASSFLGTGLNEQYF	KLVALGINAV
CASQSGFLSNSPLHF	ELAGIGILTV
CASSPWDRANTGELFF	LLWNGPMAV
CSGDAFF	FLTVFSHFM
CASSMGGVGTEAFF	ALSPVIPHI
CAWSVFNRGTGYTF	GILGFVFTL
CSARDNLAGDTDTQYF	GILGFVFTL
CASRGPYHNEQFF	LLGATCMFV
CSGGDGNTIYF	LLWNGPMAV
CSVEIWDSSYNEQF	NLVPMVATV
CATPSRAQYDYGYTF	ILGGQVVHTV
CASSLFPGFGEQYF	GILGFVFTL
CATSDFPPGVRGAPQETQYF	GILGFVFTL
CSAVMWGTSGTQGSQYF	GILGFVFTL
CASSIGDYEQYF	RLGPYLEFL
CASSDGGKDGYTF	KLVALGINAV
CASTPAGGAPGELF	NLVPMVATV
CASRTTSGGASEQF	YVLDHLIVV
CASSQTAGGYEQYF	LLWNGPMAV
CASSLGLGQPQHF	ELAGIGILTV
CASSLPETSGGLDEQF	NLVPMVATV
CSVGLAGSYNEQFF	NLVPMVATV
CASSQDHRVMRLDAGELFF	GILGFVFTL
CSARPRVFRALETQYF	NLVPMVATV
CASSVRSAYEQYF	GILGFVFTL
CASSIRAGEKLF	GILGFVFTL
CSVPSRGYAGELFF	LLWNGPMAV
CASSLAVGEDGSPLHF	NLVPMVATV
CAIREDSVFFF	GILGFVFTL
CAWSEGDNQPQHF	NLVPMVATV
CASSLGAGAYEQFF	GILGFVFTL
CASSLWAGETQYF	NLNCCSVPV
CASSRDPDGDTEAFF	GILGFVFTL
CSARDVPGTTLGGELFF	NLVPMVATV
CASSLYRGEKLFF	GILGFVFTL
CASSIYSNTEAF	GILGFVFTL
CAWIRTGGYGYTF	NLNCCSVPV
CASSYNQGPYDNNEQFF	MMPFSIVYI
CASSTPWGGTSGATDTQYF	NLVPMVATV
CASSQGPAAYEQYF	LLWNGPMAV
CAWSVLPEAFF	GILGFVFTL
CASSTRAANEQFF	GILGFVFTL
CASSGTNSPLHF	NLVPMVATV
CSAGIPGQVFSSNEKLFF	ILNAMIAKI
CASNNGKYEQYF	NLVPMVATV
CASSYFRGSLSEQYF	ELAGIGILTV
CAISELDWGVSSPLHF	GMGPLLATV
CASSSRSAGELFF	GILGFVFTL
CASSWKTGTGGTGYTF	NLVPMVATV
CASSIRSNTEAFF	GILGFVFTL
CASSEGYGGGQYF	LLAMTVPNV
CSARDVGISYEQYF	KLWASPLHV
CSDGTGDGYTF	KLNTITPVV
CASSPQTGAIYGYTF	NLVPMVATV
CASSWTGDSNQPQHF	YMPTTIIAA
CASSTQGTGVYNEQFF	ALSYTPAEV
CASSISSTGELFF	GILGFVFTL
CASSIAGDEQFF	GILGFVFTL
CASSPRSAYEQYF	GILGFVFTL
CASSIISVDGYTF	GILGFVFTL
CASSQSTSGSYEQYF	GILGFVFTL
CASSIMGSGNTIYF	GILGFVFTL
CASSVTGRWVPLHF	YLLFMIGYT
CAWDYNRGGYTF	GILGFVFTL
CASSSGRTEHNEQFF	LLWNGPMAV
CASSEDRGNSPLHF	FLYNPLTRV
CASSPTRPVEQYF	GILGFVFTL
CASRTRSAYEQYF	GILGFVFTL
CASSLGMFNTEAFF	NLVPMVATV
CASSQDGGLNGELF	ELAGIGILTV
CSARDRNTQGPETQYF	NLVPMVATV
CATTTGTESSNQPQHF	NLVPMVATV
CASSRTGTYEQYF	GILGFVFTL
CASSLTTGVFSQPQHF	ELAGIGILTV
CASSLKLNTEAFF	LLWNGPMAV
CSVGSGGTNEKLFF	GILGFVFTL
CASSPTTGASYGYTF	NLVPMVATV
CAIRGEGNTEAFF	GILGFVFTL
CASSIAPTDTQYF	GILGFVFTL
CASRDRAPSYEQYF	NLVPMVATV
CSASQPGHDSGYTF	GILGFVFTL
CASTDGGDSYTQYF	LLWNGPMAV
CASSMPTGTDSYEQYF	KMVAVFYTT
CASSVYSNQPQHF	GILGFVFTL
CATSGGQSNEKLFF	LIFNMFYWI
CASSPLRGPYEQYF	VVLSWAPPV
CASSYSPGTGNTIYF	KLVALGINNV
CSVGGGEGNYEQYF	VLFHRAFLV
CASSGRSAGELFF	GILGFVFTL
CASSGTGGYSGANVLTF	LLGATCMFV
CASRPGGGSYNEQFF	RLGPYLEFL
CASNTGTDSYEQYF	LLWNGPMAV
CASSSRSGNEKLFF	GILGFVFTL
CASSIYSGGYNEQFF	GILGFVFTL
CASSPGLASPYSYNEQFF	NLVPMVATV
CASSQDEGYEQYF	FLYNLLTRV
CSARDLQGTSWVEQFF	FMLYLLTLM
CATSGGGAYEQYF	LLWNGPMAV
CASSISSSSYNEQFF	GILGFVFTL
CSAPPAGEYSNQPQHF	NLVPMVATV
CASSLVQGAGSTISNQPQHF	GILGFVFTL
CASSLTTGIQYF	YVLDHLIVV
CASSPGTSGAYEQYF	LLWNGPMAV
CASSPGTTTNEKLFF	VLNYFEPYL
CSARDPFGTGYLNSNQPQHF	NLVPMVATV
CASSWVSLDTQYF	GILGFVFTL
CASNGGLAYEQYF	LLWNGPMAV
CASSPSGLAGGHTQYF	ELAGIGILTV
CASSLLAGPYNEQFF	GILGFVFTL
CSARGELGVDEQFF	GILGFVFTL
CAASGGSNYKLTF	VLFGLGFAI
CARSWAGGPRDEQYF	NLVPMVATV
CASSYGQNTGELF	GILGFVFTL
CASSPSLVGSADTQYF	YVLDHLIVV
CAISESPDMLMGNEQFF	NLVPMVATV
CASIPVGSRNTIYF	LMVPHSPSL
CASSETSGLIDEKLFF	SLAPLSPRV
CASSLSDRGGDEQF	NLVPMVATV
CASLQGSGSPLHF	ELAGIGILTV
CASSYVTGTGSYGYTGF	NLVPMVATV
CASGIRSSYERYF	GILGFVFTL
CASSLFARGGPTDTQYF	FILDAVQRV
CSAPGQGFNEKLFF	GILGFVFTL
CASSDLANEQF	YVLDHLIVV
CASSPPVPPWSEQYF	GILGFVFTL
CASSKRSTDTQYF	GILGFVFTL
CASSDQTGDAYEQYF	LLWNGPMAV
CSVGPPEAFF	NLVPMVATV
CASSFRRDTDTQYF	RLGPYLEFL
CSASSPDREADGYTF	VLNYFKPYL
CASSSLGGAGTGELF	NLVPMVATV
CASSYSTGAGETQYF	NLVPMVATV
CAWITEMNTEAFF	GILGFVFTL
CASSLPDRGGTKNIQYF	YLLAIFSGL
CAWSNGGRAEAFF	GILGFVFTL
CASSLVRDLLFTDTQYF	ELAGIGILTV
CASSGRWTAYNEQFF	NLVPMVATV
CSARVRGDVYGYTF	GILGFVFTL
CASKGMASGGLRGTGELFF	GILGFVFTL
CASSSSSGDEQYF	RLIKHYPGI
CASSAGLLGEQYF	NLVPMVATV
CASSPSTGYGYTF	NLNCCSVPV
CASSPIDRAGGPYEQYF	MLNIPSINV
CASSIRSSETQYF	GILGFVFTL
CATSRTSGRPSTDTQYF	NLVPMVATV
CASSLWEGREQF	NLVPMVATV
CATSSGYEAGDNYEQYF	NLVPMVATV
CSAMGMNTEAFF	NLVPMVATV
CASSSDLRTNYNEQFF	FLYNLLTRV
CASSSGSYGYTF	GILGFVFTL
CASSLIFPGELFF	GILGFVFTL
CSVEVPPGEQFF	GILGFVFTL
CASTRGVGTEAFF	GILGFVFTL
CASNSGPNEKLFF	VQYLGMFPV
CASAGPGRNQPQHF	VVMSWAPPV
CSARSGVGNTIYF	MLNIPSINV
CASSQDLGAGTEAFF	GILGFVFTL
CASGIGGYGYPF	GILGFVFTL
CASSLTSEQF	NLVPMVATV
CAISLGGAPEAF	NLVPMVATV
CSAQGTGSSGANVLTF	GILGFVFTL
CASSDWGGETQYF	ALYGSVPVL
CASAILGIRIAGF	GILGFVFTL
CASSSAHYGYTF	NLVPMVATV
CASSQGSDEQYF	ILTGLNYEV
CAVGAGATYEQYF	LLWNGPMAV
CASRGRSSYEHYF	GILGFVFTL
CASAPGLNYEQYF	ILNAMIAKI
CASLGLEYEQYF	LLFGYPVYV
CASSEEGQGRLSEQFF	GILGFVFTL
CSVDRYGGDTYEQYF	NLVPMVATV
CASSLQGMGQPQHF	ELAGIGILTV
CASTLGQGNTEAFF	YLLAIFSGL
CSVDLGTEETQYF	FMIGYTSAL
CSAPGGSGANVLTF	NLNCCSVPV
CSVTGTGLFDEQYF	YMDGTMSQV
CASSYSSGYGYTF	FLYNPLTRV
CATSEGLQYEQYF	ALYGFVPVL
CASSYLYRIGQLEAFF	GILGFVFTL
CASSIHSGANNEQFF	GILGFVFTL
CASSFPPAGTGELFF	KIVALGINAV
CASSLVSGMLYF	GILGFVFTL
CASSFQTGASYGYTF	NLVPMVATV
CASRIWYIRNEETQYF	GILGFVFTL
CASSLGIYGYTF	GILGFVFTL
CSVGLGQTGTEAFF	VMIIVSSLAV
CASSPGTGGTYEQYF	LLWNGPMAV
CASSLVGADRSGELFF	QLLVSLWGL
CASSTRAGETQYF	GILGFVFTL
CASNLGGDNEQFF	FMLYLLTLM
CASSETQMNTEAF	ELAGIGILTV
CASSSRSPYEQYF	GILGFVFTL
CASSIPSRTTNYGYTF	RLGPYLEFL
CASSQDLGTGNTIYF	AMAGSLVFL
CASSWDNGGYTF	NLNCCSVPV
CSVLRYF	GILGFVFTL
CASSFVRDSPHRDTEAFF	KMVAVFYTT
CAWSPGTVSEQYF	GILGFVFTL
CACSIRSAYEQYF	GILGFVFTL
CASSQDRGKDTQYF	FLTVFSHFM
CAISEASGVTYEQYF	LLWNGPMAV
CAWSIERELDEQFF	NLVPMVATV
CASSLGGLGQPQHF	ELAGIGILTV
CASSLGVGTEAFF	ELAGIGILTV
CASTWTGEQYF	LLFGLALIEV
CASSIRSMDIQYF	GILGFVFTL
GASSIGIFGYTF	GILGFVFTL
CASSVGGGYEQYF	KLWASPLHV
CSARGQDIYEQYF	NLVPMVATV
CASSIHHGNEQFF	GILGFVFTL
CSAPLAGGPNEQFF	LLWNGPMAV
CASSQEVLRTDTQYF	GILGFVFTL
CASRQQGLGSPLHF	ELAGIGILTV
CASSMRSGETQYF	GILGFVFTL
CSVPSYNEQFF	LIIPFIHLI
CASSIRSGNTEAF	GILGFVFTL
CASSLEGYTEAF	NLVPMVATV
CASSYTLASYEQYF	NLVPMVATV
CSAPIPPYNEQF	YVLDHLIVV
CASSIRATGELFF	GILGFVFTL
CASSISSGSYNEQFF	GILGFVFTL
CASSPSQGYGYTF	KLWASPLHV
CASSLVPSGSTDTQYF	NLVPMVATV
CASSITGWGSPLHF	GILGFVFTL
CASSHNRGYEQYF	FLNVLFPLL
CASRTGFEQYF	ELAGIGILTV
CASSQAHTGELFF	ALYGFVPVL
CASSDLAGGTDTQYF	LLWNGPMAV
CASSQEMVGTEAFF	GILGFVFTL
CASSFGPVEQYF	LLFGMPPCL
CASSMRSDEKLFF	GILGFVFTL
CASSGGTSGAYEQYF	LLWNGPMAV
CSARPWDRALATNEKLFF	GILGFVFTL
CASSLGSMQETQYF	GILGFVFTL
CATSESRGGGYGYTF	LLWNGPMAV
CASRTDRGNTGELFF	GILGFVFTL
CASSPSGVDQYF	GILGFVFTL
CASSVGEGTEAFF	NLNCCSVPV
CAWSDIWENYNSPLHF	GILGFVFTL
CASSLVAGGGETQYF	GILGFVFTL
CASSYQTGASYGYTF	NLVPMVATV
CASSIVRGLYNEQFF	GILGFVFTL
CASSLAYEQFF	GILGFVFTL
CASSEMDGSNQPQHF	FIMGISILL
CASSQGGGGTDTQYF	ALYGSVPVL
CASSLDYNEQFF	NLNCCSVPV
CASSTRTGQETQYF	NLVPMVATV
CASSYSTGIGGGYTF	NLVPMVATV
CSAPGGVNAFF	GILGFVFTL
CATSFSRMANEKLFF	SLLWMNLFV
CASSIYGLSSYNEQFF	GILGFVFTL
CASSQGRQETQYF	GILGFVFTL
CASSPWTLNEQYF	ALYGFVPVL
CASSFRGNTGELFF	FLSDHLYLV
CASSIRSDNEQFF	GILGFVFTL
CASSLFPDNYGYTF	LLWNGPMAV
CASSPQRTAHEQYF	GILGFVFTL
CASSYGQGTGIQYF	GILGFVFTL
CASSYQTGAGGYGYTGF	NLVPMVATV
CASSWGSSPAETQYF	LLFGMPPCL
CASSPDSYNQPQHF	GILGFVFTL
CASSPILTYEQYF	MMPFSIVYI
CATSPYSVTTFANTIYF	ELAGIGILTV
CASSETGVGGYTF	GILGFVFTL
CASSWVGGADTQYF	LLAILTYYV
CASSLVGAEAFF	LLSIIFFPA
CASSLGAYNSPLHF	LLWNGPMAV
CSARDPVGGSNTGELFF	QLLVSLWGL
CASSWTGANYGYTF	LLGATCMFV
CSATEGSGYTF	KIVALGINAV
CASSTGQGGDTQYF	GLTSFFIAI
CASSIRSTGELFF	GILGFVFTL
CASSPTGDNTGELFF	NLVPMVATV
CASGGRSSYERYF	GILGFVFTL
CASSLNSSSYEQYF	GILGFVFTL
CASSDDRVRYGYTF	NLVPMVATV
CATSRDLAEVNTEAFF	NLVPMVATV
CASSPVAGATTDTQYF	GILGFVFTL
CSAHRAGTSGADYNEQFF	SLLWMNLFV
CASSPHSGGDPRNEQFF	YVLTWIVGA
CASSYFFEGLNTGELFF	KMVAVFYTT
CASSYGQGTGELF	GILGFVFTL
CASSQEDGTGSAGELFF	GILGFVFTL
CSVRDRASYEQYF	NLVPMVATV
CASRTRPAYERDF	GILGFVFTL
CASSFLGDTQYF	ELAGIGILTV
CASSLIQGAVDTQYF	LLFGMPPCL
CASSPDPYEQYF	LLFGMTPCL
CASSGQGAYGYTF	LLWNGPMAV
CSVERGGDEQFF	MMPFSIVYIV
CASSIRSAIEQYF	GILGFVFTL
CASTLAGGTDTQYF	NLVPMVATV
CASRQDRWEKMGQNIRRF	VLFGLGFAI
CASSEGQGYEQYF	VLENFTIFLV
CASSMRSAYEQYF	GILGFVFTL
CASSIRSVAEAFF	GILGFVFTL
CASGAGGPLNEQFF	GILGFVFTL
CSAFDRVYGYTF	GILGFVFTL
CASSLASQVETQYF	YLWPPVQLA
CASSLMGPGQPQHF	NLVPMVATV
CASSPWTGTLNTEAF	NLVPMVATV
CASSGGQAYEQYF	LLWNGPMAV
CASSYSLAAAYNEQFF	GILGFVFTL
CASSFGQGGYEQYF	GILGFVFTL
CASTLGGGYEQYF	GILGFVFTL
CASTDGTAFTEAFF	GILGFVFTL
CASSLIRQMNTEAFF	GILGFVFTL
CSASGGRQRTEAFF	GILGFVFTL
CASSDGRADTQYF	VLFHRAFLV
CAWSSADTYYEQYF	GILGFVFTL
CASSYSGDYNEQFF	GILGFVFTL
CASSVTSGNDEQFF	GILGFVFTL
CSARGPSGANVLTF	GILGFVFTL
CASSIGIYGYTF	GILGFVFTL
CAISDPDRGGRAFF	ALSPVIPHI
CASSQQTGTIGGYTF	NLVPMVATV
CASSPLSLGSPYNEQFF	GILGFVFTL
CASSITSSYNEQF	GILGFVFTL
CASRKDNGVAGELFF	GILGFVFTL
CASGLRGPYERNF	GILGFVFTL
CASSLIGGAQNIQYF	VLNYFEPYL
CASSPQGSGGEAFF	ELAGIGILTV
CASVLGGSSYNEQFF	SIIGRLLEV
CASSQWDLQETQYF	GILGFVFTL
CASSFGSGNTIYF	FMIGYASAL
CASSTGISYEQYF	KMVAVFYTT
CASSIRSTNEQFF	GILGFVFTL
CSDGQAFF	NLVPMVATV
CASSRGGGTEAFF	KLVALGINAV
CASSISTSGYEQFF	NLNCCSVPV
CASLQAGANEQF	NLVPMVATV
CASSPRTSGSLSYEQYF	GILGFVFTL
CASSQVIDQETQYF	NLVPMVATV
CASSPGGTEAFF	ELAGIGILTV
CASSLAPLSTDTQYF	GILGFVFTL
CASSHEGAGANVLTF	NLVPMVATV
CSVEGPGGRIANTEAFF	NLNCCSVPV
CSAEGNTEAFF	GILGFVFTL
CASSPVTGGIYGYTGF	NLVPMVATV
CSWDFQETQYF	ALYGSVPVL
CASSGQGGTEAFF	GILGFVFTL
CASSRGQLYEQYF	GILGFVFTL
CSARIPTSGGPETQYF	GILGFVFTL
CASSIVSTGELF	GILGFVFTL
CASSFSGDTEAFF	GILGFVFTL
CASNPSGGYTGELF	NLVPMVATV
CASSSSGTGAYEQYF	GILGFVFTL
CASSGVGGTDTQYF	NLVPMVATV
CSASVSGGPLDTQYF	MIISHLYLI
CASSAGTVSYEQYF	LLWNGPMAV
CASSYGGGYEQYF	NLNCCSVPV
CASSRRSTDTQYF	GILGFVFTL
CASSETGTQAYEQYF	LLWNGPMAV
CASSLNREGNTEAFF	ALYGFVPVL
CAISETTGINEQFF	ELAGIGILTV
CASSYATEVAGETQYF	NLVPMVATV
CAWSGYSYEQYF	KLMNIQQKL
CASSSRAVDEQYF	GILGFVFTL
CSAKLGQDHTGELFF	GILGFVFTL
CASSIGPNYGYTF	FLYNPLTRV
CASSFVGGIDGYTF	NLVPMVATV
CASSQRQGSGANVLTF	GILGFVFTL
CASSYSDAGGYYEQYF	FLYNLLTRV
CASSFGQGYEQYF	LIFNMFYWI
CASGGLSTDTQYF	GILGFVFTL
CASSLSGSSYEQYF	GILGFVFTL
CASSIGGQRYNEQFF	SLDLTTSPV
CASSAGGDTEAFF	KLVALGINAV
CAISEVLTGAYGYTF	LLWNGPMAV
CASLEAGGETQYF	YVLTWIVGA
CASSQDWGAEAFF	LMLWASSSI
CATAITSTQYF	NLVPMVATV
CASSYSEQGYGYTF	LLWNGPMAV
CASSGQGGDEQYF	ILTGLNYEV
CAISSDRTDEQYF	KLVALGINAV
CASSQGQGLQETQYF	SLLWMNPFV
CASTPGTSASRDTQYF	SLDLTTSPV
CAIQGFSGPLHF	ILNAMIAKI
CASRTVNSPLHF	GILGFVFTL
CASSTPGAKLGDTGELFF	NLVPMVATV
CASSQWTGGGGQPQHF	GILGFVFTL
CASSLGQGRETQYF	GILGFVFTL
CSSVTEAFF	NLNCCSVPV
CASSRPGQGGYEQYF	NLVPMVATV
CATSKTADRSPYEQYF	VLNPFIYML
CASSIAQGGNQPQHF	VLENFTIFLV
CASSVWAGGYNEQFF	VVMSWAPPV
CASSSVSGGAFNEQFF	GILGFVFTL
CASSWTGNTEAFF	VVLSWAPPV
CASSPMTDSTDTQYF	AMAGSLVFL
CASSPRLAGGKYNEQFF	FLYNPLTRV
CASSSRLSQETQYF	VVMSWAPPV
CSARDAGLAGLNGAPSSYEQYF	NLVPMVATV
CSGGTGELF	NLVPMVATV
CASSDGTGGILYEQYF	GILGFVFTL
CASSMFVGQPQHF	GILGFVFTL
CASRWGQLTNYGYF	ELAGIGILTV
CASRTGRTEAFF	GILGFVFTL
CASSPHGGGNTEAFF	GILGFVFTL
CATSRTGTGSTEAFF	LLWNGPMAV
CASSFLGTGLNEQYF	YLVALGINAV
CASSQADHYEQYF	MMPFSIVYIV
CSARSRGGGIETQYF	ELAGIGILTV
CASSQAGDGSYEQYF	KLGASPLHV
CAWSAVGGGYTF	GILGFVFTL
CASSPFWGGEQYF	GILGFVFTL
CASSIVPMFGEQYF	NLVPMVATV
CASSIGGNGYPF	GILGFVFTL
CASSDPRGQPNQPQHF	SVLENFTIFL
CASSSRTGGEQYF	GILGFVFTL
CASSIDSNQPQHF	GILGFVFTL
CASSSRSGIEQFF	GILGFVFTL
CASSETSGRSPYEQYF	NLVPMVATV
CASSLGVGPGYEQYF	GILGFVFTL
CASSLAGGGEQYF	YVLDHLIVV
CASSSETELLYYGYTF	NLVPMVATV
CASSIRAQETQYF	GILGFVFTL
CASSESGRAEAFF	IMLEALERV
CASSLGQGYNEQFF	VQYLGMFPV
CASSARATDTQYF	GILGFVFTL
CASNIAGDYGYTF	NLVPMVATV
CASSEYQEPYNEQFF	KLNTITPVV
CSARVQGAYEQYF	GLMAIAWFI
CASSFGPDEQYF	GMGPLLATV
CSETGVSDEQFF	GILGFVFTL
CASSSIFPGELFF	GILGFVFTL
CASSPRAYNEQFF	ILTGLNYEA
CASSETGQPQHF	LLWNGPMAV
CASSEGPGQGSYEQYF	LLWNGPMAV
CASSPGSSFYGYPF	NLVPMVATV
CASSLEGFTEAFF	NLVPMVATV
CASSLDLAGGFYEQYF	LLAGTLAVV
CASSLTPSASGYEQYF	LLWNGPMAV
CASSSGTGHTGELFF	NLVPMVATV
CSVDTLGRGGTEAFF	GILGFVFTL
CSVQRPAAYNEQFF	GILGFVFTL
CASSIVASGGRYF	GILGFVFTL
CASSQGWDEQYF	VLMGGVPGVE
CASSSRATGELFF	GILGFVFTL
CASSGRSGIEQYF	GILGFVFTL
CASSMRSAGELFF	GILGFVFTL
CASSHRGSGNTIYF	NLAQTDLATV
CASSTRPSYEQYF	GILGFVFTL
CASSSGPTMGGKLFF	ELAGIGILTV
CASSRDRDLNQPQHF	NLVPMVATV
CSARVEFGTSGQLSSYNEQFF	NLVPMVATV
CATDGAGGADGLTF	GILGFVFTL
CASSLYSDTQYF	YVLDHLIVV
CASSQDGGGAPGNEQFF	GILGFVFTL
CASSYVRAQETQYF	RLGPYLEFL
CASSGGQGWTDTQYF	TAMDIFVTV
CSVVGSERRSSYNEQFF	GILGFVFTL
CASSFSVWDSNQPQHF	KLNTITPVV
CACTLVSTEAFF	GILGFVFTL
CASSIQALLTF	NLVPMVATV
CASSFRSQETQYF	GILGFVFTL
CASSYFRRLPGQVFYEQYF	GILGFVFTL
CASSEGQGSRQPQHF	VLNYFEPYL
CASSSVAGGFFSYEQYF	NLVPMVATV
CATSDLKVHSGNYGYTF	NLVPMVATV
CASSLGQGLSYEQYF	YMDGTMSQV
CASSSFGNREYEQYF	NLVPMVATV
CASSYQTGTIYGYTF	NLVPMVATV
CSVQRRADEQFF	LLWNGPMAV
CSARSWDRSELMGYTF	GILGFVFTL
CASSSRPFWDRAMEGANVLTF	GILGFVFTL
CASSPGKTEAFF	IMLEALERV
CASSQNPGQGIYSPLHF	SLLWMNPFV
CASSLDGPTQYF	LLFALHFSA
CASSIRSLDIQYF	GILGFVFTL
CATSTYRVGSSDEQYF	GILGFVFTL
CASSLGGASYEQYF	LLWNGPMAV
CASSLTALGAAYVYTF	LLWNGPMAV
CASSLSPGQGDTQYF	NLVPMVATV
CSARTIAGEGYNEQFF	GILGFVFTL
CASSLEVGQETQYF	GILGFVFTL
CASSQGYEQYF	VLFAAFSSA
CASSVPGTPNTEAFF	LLSIISFPA
CASRSYVASSNEQFF	ELAGIGILTV
CASSSSGGEYNEQFF	GILGFVFTL
CASSSRGDSWAETQYF	GILGFVFTL
CASSPVPGLDEQFF	VLFGLGFAI
CASSMVGGVYGYTF	GILGFVFTL
CASSGRDRQNTEAFF	LLWNGPMAV
CASSQTYEQYF	GILGFVFTL
CAWSAVGGGYGYTF	GILGFVFTL
CASSQVLGFSYEQYF	NLFNRYPAL
CAISESYEQYF	NLVPMVATV
CAWSVPGLGQPQHF	ELAGIGILTV
CATPTNLGGGGGNYF	GILGFVFTL
CASSYRSSYEQYF	GILGFVFTL
CASSTVSSYEQYF	GILGFVFTL
CASSVSGATADTQYF	GILGFVFTL
CASTLWSATNEKLFF	NLVPMVATV
CAWSISDLAKNIQYF	NLVPMVATV
CASRTGTSGGFPNTGELFF	MLYQHLLPL
CSARDKAGEGYNEQFF	GILGFVFTL
CASSIRSAGELF	GILGFVFTL
CASSESMIQHF	NLVPMVATV
CASSLQGLGTEAF	ELAGIGILTV
CASSWDRGTYEQYF	YLDELIRNT
CSVEEWASRYNEQF	NLVPMVATV
CASSTGLYGYTF	GILGFVFTL
CASSPGTDIYEQYF	GILGFVFTL
CASSIYSVNEQFF	GILGFVFTL
CASTLAGGPYEQYF	NLNCCSVPV
CASSPGTADYNEQFF	GILGFVFTL
CSARVAGVEDTQYF	GILGFVFTL
CSAARTGGNEKLFF	GILGFVFTL
CASSPYHTNEQFF	GILGFVFTL
CASSVGSTEAFF	ILTGLNYEV
CASSFIGGVDGYTF	NLVPMVATV
CASTGTSGALYNEQF	NLVPMVATV
CASLYSGSTGELF	ELAGIGILTV
CASSPSPAGAYEQYF	ELAGIGILTV
CASSPDGPYNEQFF	GILGFVFTL
CSVAPSYNTGELFF	GILGFVFTL
CASSIRSQETQYF	GILGFVFTL
CASSQSETGDGYTF	ALIHHNTHL
CASSGSRVPYEQYF	MLNIPSINV
CASNSGGYNEQFF	ELAGIGILTV
CSANSDRVSYNEQFF	GILGFVFTL
CASSQEGTSRPQHF	LLWNGPMAV
CASSNARGYGYTF	FLYNPLTRV
CASSFGVGQPQHF	LMFWASSSI
CASSIYSSSYNEQFF	GILGFVFTL
CASSFGQEEGQPQHF	YMLTLHTKL
CASSLGPMEENIQYF	ILNVDVFTL
CASSPQGFSYEQYF	LLWNGPMAV
CASSQDGGVTQYF	ELAGIGILTV
CASSPGGVSYGYTF	LLWNGPMAV
CASSPYGQGGRDTEAFF	ILNAMIAKI
CANGQGDYEQYF	LLAGTLAVV
CASSRGLQETQYF	FLNVLFPLL
CASSIRSSAEAFF	GILGFVFTL
CASSFGGLARNEQFF	ELAGIGILTV
CASSQGQLSSYNEQF	ELAGIGILTV
CSVEDPAGTYEQYL	NLVPMVATV
CASSLPAGVGDTQYF	SLPITVYYA
CASSYPNQPQHF	LLWNGPMAV
CASSLGIVEQFF	GILGFVFTL
CASSLGQGQPQHF	ELAGIGILTV
CASSQEQGDIQYF	NLVPMVATV
CASRWTGFSEQFF	NLVPMVATV
CASSVDFGRTYNEQFF	LLAMTVPNV
CASSIVGQGYEQYF	NLNCCSVPV
CASSQGTISYEQYF	LLWNGPMAV
CASSSSSVNEQFF	GILGFVFTL
CASSSGGGQPQHF	KLVALGINAV
CASSFDLAGVNYEQYF	LLWNGPMAV
CASSPLDTKQQFF	GILGFVFTL
CASSQGFYGYTF	GILGFVFTL
CASSSQGLSTEAFF	LLWNGPMAV
CAISDLDSNQPQHF	KMVAVFYTT
CASSLGDTEQFF	LLGATCMFV
CASSVTPSSYNEQFF	NLVPMVATV
CASSLGISYEQYF	NLNCCSVPV
CASSQGGGPGANVLTF	NLVPMVATV
CASSLNLRDREAYEQYF	GILGFVFTL
CAWSVILWGRGPTDTQYF	GILGFVFTL
CSVETGGYNEQFF	NLVPMVATV
CASSSRSGETQYF	GILGFVFTL
CASSLLQGPSYEQYF	GILGFVFTL
RASSPPGETQYF	GILGFVFTL
CASSPTGGLETQYF	GILGFVFTL
CASSALAGGYNEQFF	YTSEILSPI
CASSQERGGKWAYEQYF	GILGFVFTL
CATWTGTYEQYF	YVLDHLIVV
CASSIDGNVAPLHF	GILGFVFTL
CASSPGAVSSTDTQYF	GILGFVFTL
CASSKQGESNSPLHF	LLWNGPMAV
CASSPGAGLYNEQF	YVLDHLIVV
CASSFFPGELFF	LMVLHSPSL
CASSQFVYTSTDTQYF	NLVPMVATV
CASSPTGQGAHGYTF	LLWNGPMAV
CASSAGDRTYEQYF	GILGFVFTL
CASSLADLYSYEQYF	KMVAVFYTT
CASSEFTRSYEQYF	MIISHLYLI
CSVWKENAFEQFF	FLYNLLTRV
CSVRTGRDEQYF	GILGFVFTL
CASSPLLSESYNEQFF	GILGFVFTL
GASSFQGFTEAF	NLVPMVATV
CASSLGGQGAYEQYF	LLWNGPMAV
CACSLRSQGTDTQYF	NLVPMVATV
CASSQDLNEQYF	VLNPFIYML
CASSLATGPYSRGTIYF	MMPFSIVYI
CASSDNDWRLQYF	FLGIYTVTV
CASSLAPGTTNEKLF	NLVPMVATV
CASSQDPAGVGYEQYF	GILGFVFTL
CSARDYFADTQYF	NLVPMVATV
CASSTTGGGNYEQYF	IMDQVPFSV
CASTYGGLNEQYF	ELAGIGILTV
CASSSGQLSNTGELF	NLVPMVATV
CSARVVPGVQETQYF	NLVPMVATV
CSVEDISGYNEQFF	GILGFVFTL
CVSSIRSAYEQYF	GILGFVFTL
CASSLTEAHGYTF	NLVPMVATV
CASSLASPETQYF	NLVPMVATV
CASSQGLSYEQYF	MLNIPSINV
CASSTYSQDTQYF	GILGFVFTL
CASSPWLTSGYTDTQYF	NLVPMVATV
CASSWAPHYEQYF	YLEPGPVTA
CASGLGPTYEQYF	GILGFVFTL
CASSAGGTPDQPQHF	LLWNGPMAV
CASSSAVIRGLDWCYTF	GILGFVFTL
CASSIAVSLAKNIQYF	VMPFSIVYIV
CASNRGYNEQFF	ILTGLNYEV
CASTAGGGTDTQYF	FLYNLLTRV
CASRVVGHPQHF	GILGFVFTL
CAVLMDNDMRF	GILGFVFTL
CASSIRSGYEQYF	GILGFVFTL
CSVAQTGGYEQYF	GILGFVFTL
CSALDRAIANTGELFF	GILGFVFTL
CASSLGVGQPQHF	ELAGIGILTV
CASSLAVQRPSGNTIYF	ALIHHNTHL
CASSLGQDTDTQYF	GILGFVFTL
CASSQGGYGYTF	LLWNGPMAV
CASSLSGFGNTIYF	LMVLHSPSL
CASSVDGGSQPQHF	LLWNGPMAV
CSVQGNSEAFF	ILIVMFPFL
CASSTGQGMDTEAFF	GILGFVFTL
CASSLVQDGLATNEKLFF	GILGFVFTL
CASSYARGYNEQFF	VLNYFEPYL
CASSGQGMGYTF	ELAGIGILTV
CASSAYNEQFF	LLWNGPMAV
CASSYSIGALEAFF	NLVPMVATV
CASMTGTEAFF	GILGFVFTL
CSVPGGSGYTF	GILGFVFTL
CASRIRGSYEQYF	GILGFVFTL
CAWSEIGGGYGYTF	GILGFVFTL
CSALTGSSYEQYF	YVLDHLIVV
CASMGGSNEQFF	NLVPMVATV
CASSLGRDLNQPQHF	NLVPMVATV
CAWSPGTGAYGYTF	GILGFVFTL
CASSLAVEGVSRMNTEAF	YVLDHLIVV
CASSWEGINYGYTF	GILGFVFTL
CASSLGRGIYEQYF	NLVPMVATV
CATSPSLGTQYF	MMPFSIVYI
CASSQASGGPINEQFF	NLVPMVATV
CASSIRGANQPQHF	GILGFVFTL
CASSTRSSSEQYF	GILGFVFTL
CASSPAELRGNTIYF	GILGFVFTL
CASSGPRGYTF	ILNAMITKI
CASSSNIWSPDTQYF	RLIKHYPGI
CASSHSGYEQFF	LLWNGPMAV
CSAPGPGGTEAFF	GILGFVFTL
CASSIISADTQYF	GILGFVFTL
CASSPRSSEPQHF	GILGFVFTL
CASSPGGYYGYTF	LLSIIFFPA
CSARVTSGSYEQYF	NLNCCSVPV
CASSWAGEPRDEQYF	NLVPMVATV
CASVNDGATYEQYF	NLVPMVATV
CASSIRSNQPQHF	GILGFVFTL
CASSTTEAYEQYF	IMDQVPFSV
CASSQGGDGYGYTF	LLWNGPMAV
CSARDRSGIDTQYF	FMIGYTSAL
CASSMVSIDEQFF	GILGFVFTL
CAISDLSITGGDNYGYTF	GILGFVFTL
CIAQGAQKLVF	GILGFVFTL
CASSLNMNTEAFF	MLLKHDVSL
CASTSWGETQCF	GILGFVFTL
CASKDNISFRGYTF	GILGFVFTL
CASSIFGGQNQPQHF	NLVPMVATV
CASSIGQGSGYEQYF	GILGFVFTL
CASSGEGVGQPQHF	GILGFVFTL
CASSVQGFTEAF	NLVPMVATV
CASSPQTGVGNYGYTF	NLVPMVATV
CASSGGTGAYEQYF	LLWNGPMAV
CAWSGGGGRVHEQYF	ELAGIGILTV
CAIRDRLNTEAFF	RLGPYLEFL
CAWSRVGGYEQFF	GILGFVFTL
CASSQAERGESYNEQFF	FLYNPLTRV
CASSFGDSYEQYF	LLWNGPMAV
CASFNTGELFF	LIFNMLYWI
CASSFSGQNTEAFY	GILGFVFTL
CASSPRSAGELF	GILGFVFTL
CASSYFGGSLSEQYF	ELAGIGILTV
CASSLHYTGENTEAFF	GILGFVFTL
CASSPGLAYEQYF	LLWNGPMAV
CASSSAGTEAFF	VLLGVKLSGV
CASSYGLEQFF	GILGFVFTL
CASSYGTGGREQYF	GILGFVFTL
CASSLGPNRGAEQYF	GILGFVFTL
CASSPGQGYEQYF	KLWASPLHV
CASSGGGAGNEQFF	LIIPFIHLI
CASSEVEGPGELFF	LLFALHFSA
CAISETGGGQPQHF	ALSPVIPLI
CASSYMGVEQF	YVLDHLIVV
CASSDRQGIATGELFF	FMIGYASAL
CASSGDFPNEQFF	GILGFVFTL
CASSETSLFTHGYTF	MMPFSIVYI
CSVVVGDLYNEQFF	GILGFVFTL
CASSSANYGYTF	GILGFVFTL
CASRMGTSGSTDTQYF	ALYGFVPVL
CASSLGGPGAFF	LLFGMTPCL
CASKSWDMAYEQYF	ALSPVIPHI
CSALPGIYNEQFF	GILGFVFTL
CASRGSGASTGELFF	ALYGFVPVL
CASSVAPGRDGYTF	LLWNGPMAV
CASSQDSSGGPYNEQFF	GILGFVFTL
CASSLGPAYNEQFF	MLNIPSINV
CASSFLTGTGELFF	LLGATCMFV
CASSIVDRPYEQYF	VLNYFEPYL
CASSRYGGPSDNEQFF	KMVAVFYTT
CASSLKGNTEAFF	LLWNGPMAV
CASSQVTGYEQYF	NLNCCSVPV
CASSEIQAFEETQYF	KMVAVFYNT
CASSSPSGGRTDTQYF	NLFNRYPAL
CASSVDPGQSYEQYF	ILTGLNYEV
CASSVYSGGYNEQFF	GILGFVFTL
CASSWGLDNEQFF	GILGFVFTL
CASRNTGTTNEKLFF	MLLKHDVSL
CASSGSSGYEQYF	LLWNGPMAV
CASSLFGGGTEAF	NLVPMVATV
CASSFRSSYEQYF	GILGFVFTL
CASSLGGPAEQYF	VVLSWAPPV
CASSRRSNQPQHFT	GILGFVFTL
CASSLRVSYNEQFF	GILGFVFTL
CASSFGGTQYF	GILGFVFTL
CASSIRSSVEQFF	GILGFVFTL
CASSVALGLNYEQYF	NLVPMVATV
CASSIVDGYEQYF	NLNCCSVPV
CASRTGTRALYEQYF	GILGFVFTL
CASSLGSSYEQYF	YLEPGPVTA
CASSLAGTPTDTQYF	NLVPMVATV
CASSWGGAYEQYF	LLWNGPMAV
CASSEMGKSSYEQYF	GILGFVFTL
CASSLSWGYEQYF	GILGFVFTL
CAWSVGNYGYTF	VLLGVKLSGV
CASSVWADPNEAF	ELAGIGILTV
CAWSGGTSRRTQYF	GILGFVFTL
CASSYSLAAEAFF	NLNCCSVPV
CAWSLSMNTEAFF	GILGFVFTL
CASSVSGGASNEQF	NLVPMVATV
CASSFFSKKYNNEQF	NLVPMVATV
CASSRPLNQPQHF	VVLSWAPPV
CASSFSTGYADGYTF	NLVPMVATV
CASSSETNWGTGGNQPQHF	SLLWMNPFV
CSARAEGARDSPLHF	NLVPMVATV
CASSVQGLGQPQHF	ELAGIGILTV
CASSQGTSGNEQFF	LLWNGPMAV
CASSFLQGNQPQHF	NLVPMVATV
CASGLTGFMDEQYF	NLVPMVATV
CASSPDVGHEKLFF	ELAGIGILTV
CASSGRFLREGMTYGYTF	VLFGLGFAI
CSARDQTAYYGYTF	NLVPMVATV
CASSIRSAWAQYF	GILGFVFTL
CASSAFGIVADTQYF	ILIVMVPFL
CASSDSSVSEQFF	GILGFVFTL
CASSSGSPYNEQF	ELAGIGILTV
CSVEQGGDTQYF	MMPFSIVYIV
CASSYRFDSPLHF	SIIGRLLEV
CASSFSSTDTQYF	GILGFVFTL
CASSVPGQGVLEQYF	LLSIIFFPA
CASGPGSSYNEQFF	GILGFVFTL
CASSYVNGGAIGGELFF	KLLAGVEIV
CASSRLGDGDSNQPQHF	NLVPMVATV
CASSFGGNEAFF	NLVPMVATV
CASSQVSSTGELFF	LLWNGPMAV
CSATGNRGADTQYF	LLWNGPMAV
CIVRVAMGAGNMLTF	GILGFVFTL
CASSRSGNYGYTF	LLWNGPMAV
CASSTRSGYEQYF	GILGFVFTL
CSGKRDTSWTDTQYF	NLVPMVATV
CASSSTGTGITGELFF	GILGFVFTL
CASSPVLGSTEAFF	GILGFVFTL
CASSIRSQVEQFF	GILGFVFTL
CASTPQTGTGTYGYTF	NLVPMVATV
CASSTEETQYF	NLVPMVATV
CASSSGLLGGQPQHF	ELAGIGILTV
CASSPRGGMTQHF	GILGFVFTL
CASSQDPGSNQPQHF	FMLYLLTLM
CASSFYSSGRNSYF	NLVPMVATV
CASSTRDRREKTQYF	GILGFVFTL
CAPRPGPRSTDTQYF	NLVPMVATV
CSAWDSYTGELF	NLVPMVATV
CASSEVSVLYEQYF	VVLSWAPPV
CASSTWSTDTQYF	GILGFVFTL
CASSQGPNFNEKLFF	KMVAVFYTT
CASSPLAFYFNEQF	GILGFVFTL
CASSSQELTEAFF	VLENFTIFLV
CASSQDDRGFYEQYF	VLNYFEPYL
CASSVVERAFF	NLVPMVATV
CASSFASGGYNEQFF	YLLFMIGYT
CASSATGSTYEQYF	GILGFVFTL
CSAETGRDLEAFF	LLAMKVPNV
CASSEAFGRPNYGYTF	LLWNGPMAV
CASSQGGGTEAFF	LLWNGPMAV
CASSAANTGELFF	GILGFVFTL
CASSWLMGTTYNEQF	NLVPMVATV
CATSRWTGNEQFF	NLFNRYPAL
CASSQAGVGGELFF	ELAGIGILTV
CASSLAYSYEQYF	YLEPGPVTA
CAISQQSSYKQYF	GILGFVFTL
CASSVRSGDTQYF	GILGFVFTL
CASSSQTGPYSNQPQHF	MMPFSIVYI
CASSLVPLSPEQYF	ALWGPDPAA
CASSSAWDYYNEQFF	GILGFVFTL
CARTGAGGNTIYF	VMPFSIVYI
CASSHGAEAFF	GILGFVFTL
CASSPSGTGFYEQYF	FLYNPLTRV
CASSAAGNQPQHF	LLWNGPMAV
CASSFGRGSYEQYF	GILGFVFTL
CASREQGMNTEAFF	MIISHLYLI
CSGGLKADTQYF	LLWNGPMAV
CASSPRGVGTEAFF	ILNVDIFTL
CASSLPGRNYEQYF	GILGFVFTL
CASSLGGGGPQETQYF	TMSFSHLFYL
CASSQGQLNQPQHF	LLWNGPMAV
CAWSISDSSRVEAFF	NLVPMVATV
CASSYGGSSYEQYF	SLLWMNLFV
CASSWTSGSAEQYF	ELAGIGILTV
CASSQGPNYEQYF	KLWASPLHV
CASSLTGSPYEQYF	GILGFVFTL
CASSYGQGLYEQYF	GILGFVFTL
CASSTRSSYEQYF	LLWNGPMAV
CASSFGPGYEQYF	VVMSWAPPV
CASSQDGGTSGGGQI	ELAGIGILTV
CASDPDSLIHNTGELFF	KLAKPLPYT
CASSQERQTILEAFF	GILGFVFTL
CASTPAGGRDEQYF	GILGFVFTL
CASSVGLPYEQYF	NLVPMVATV
CASSSVTEAF	NLVPMVATV
CSPIQDSLGYTF	GILGFVFTL
CSVEDLGYPTSDTQYF	GILGFVFTL
CASMRPTSYEQYF	KLNTITAVV
CASSPRGMSYEQYF	GILGFVFTL
CSVEDVASGSGEQFF	GILGFVFTL
CASSPIGGGSNEQFF	ELAGIGILTV
CASSNLPGTVEAFF	NLVPMVATV
CASSIKPDGYEQYF	LLWNGPMAV
CASSLDSTGGIGELFF	NLVPMVATV
CASSQDGKGATYNSPLHF	GILGFVFTL
CASSQTQLWETQYF	NLVPMVATV
CASSLDPGSSGANVLTF	NLVPMVATV
CASSSVSGYTF	NLVPMVATV
CASRIPDRNEQFF	SVLENFTILL
CASSSRQGAGDTQYF	VVLSWAPPV
CASSIRSSYNEQF	GILGFVFTL
CASSPPSAGYNEQFF	GILGFVFTL
CASSPGLDYEQYF	MLNIPSINV
CASSSDINYGYTF	FLYNPLTRV
CASSPVLGTYGYTF	SLAPLSPRV
CSARDNLQARYGYTF	NLVPMVATV
CASSLAQSDSLAFF	RMAAISNTV
CASSTRATGELFF	GILGFVFTL
CATSPLLESNYGYTF	GILGFVFTL
CASSYESGAEAFF	GILGFVFTL
CASSRGTRGRSETQYF	GILGFVFTL
CASSYGGGEDYGYTF	NLVPMVATV
CASSPVGDTQYF	ILIVMFPFL
CASSIFSNQPQHF	GILGFVFTL
CASSSDRGGYNEQFF	GILGFVFTL
CASSIFSGGQNIQYF	GILGFVFTL
CASSEPGNRMNTEAFF	GILGFVFTL
CASSIGWSGYTF	GILGFVFTL
CASSPLGLAEQETQYF	VLFHRAFLV
CASSESGAAYTGELFF	YVLTWIVGA
CASSEALGSTSYEQYF	LLWNGPMAV
CASSQVEAFYEQYF	GILGFVFTL
CASSPGQAEPQHF	LLAGTLAVV
CASSIGLYGYTF	GILGFVFTL
CASSLRGEKNNYGYTF	GMGPLLATV
CASSRLYGNTGELFF	NLVPMVATV
CASSQGRGEQFF	NLVPMVATV
CASSLVPDRGVAGELFF	GILGFVFTL
CASSYRGQSNQPQHF	ELAGIGILTV
CASSPAGVSYEQYF	LLWNGPMAV
CASSFRDSSYEQYF	ALSPVIPHI
CASSGDKNEAFF	ILLDWAANI
CASSLGQGATF	GILGFVFTL
CASSPAGQGAGTGELFF	LLWNGPMAV
CASSFLSSYNEQFF	KLSREIMPV
CASSLSVFPGRAEQYF	FIFSYVVAV
CASTSRGVSKVFF	GILGFVFTL
CASSLGDRPSTDTQYF	GILGFVFTL
CASSPPAGSYNEQF	NLVPMVATV
CASSLGTSGTDEQF	NLVPMVATV
CASSLQVASGSREEQFF	NLVPMVATV
CASGPGTSATDTQYF	NLVPMVATV
CASLVASGQETQYF	NLVPMVATV
CASRIGINGYPF	GILGFVFTL
CASSQGLAGDLQETQYF	GILGFVFTL
CASSSTGTGGSYNSPLHF	KMVAVFYTT
CAIMSSGRADGELFF	NLNCCSVPV
CASSWSGGGARDTQYF	NLVPMVATV
CSAREAWRGRTEAFF	NLVPMVATV
CASSLVIGDRGHSEQYF	NLVPMVATV
CASSEWAGGGTDTQYF	GILGFVFTL
CASSLSPGYTEAFF	YVLTWIVGA
CASSIRSAYERYF	GILGFVFTL
CASSPNGGSSYNEQFF	GILGFVFTL
CASSQDKGRAYEQYF	GILGFVFTL
CASSHLLDRGQETQYF	NLVPMVATV
CASSYYGTTDEQYF	GMGPLLAMV
CASSLKLAGTDTQYF	LLWNGPMAV
CASSIHFSAGQPQHF	GILGFVFTL
CSVEAGEETQYF	NLVPMVATV
CASSLRAGEVEQFF	GILGFVFTL
CASGLVPGGVVYEQYF	GILGFVFTL
CSARGGGFETQYF	KLANPLPYT
CASSVETGGLDTQYF	ALSPVIPHI
CASSIHGADTQYF	GILGFVFTL
CASSLRSTDTQYF	GILGFVFTL
CASSPRQGNDEQYF	LLWNGPMAV
CASSIRSAYEQYF	GILGFVFTL
CASSIHSGGNTEAF	GILGFVFTL
CASSIISSHTQYF	GILGFVFTL
CSARDWGYEQYF	TAMDIFVTV
CASSQDNNEQFF	LLAMKVPNV
CASSVGSYGYTF	GILGFVFTL
CASSMLLGGGQPQHF	YVLDHLIVV
CSVLPPDRGLNQPQHF	GILGFVFTL
CASSFVNTGELFF	LLGATCMFV
CSARDGLAGHYEQYF	NLVPMVATV
CASSQDLTSEAFF	GILGFVFTL
CASSTSLGGGARQYF	GILGFVFTL
CASSPTGTGGSDTQYF	LLAILTYYV
CASSFAPGQGIEKLFF	VVLSWAPPV
CASSPSMSTEAFF	NLVPMVATV
CASSFWGLPHQETQYF	KMVAVFYTT
CASSVTAGGPFLLYNSPLHF	NLVPMVATV
CASSIRSSYEQYF	GILGFVFTL
CASSLLSGGSYNEQFF	NLVPMVATV
CSVPGTAYEQYF	FLGIYTVTVV
CASSWWLNTEAFF	LIIPCIHLI
CSVEAGGVSEAFF	KLNTITAVV
CASSSAVIRGLDGGYTF	GILGFVFTL
CASRALRGDNEQF	NLVPMVATV
CASSRRDSNTEAFF	LLWNGPMAV
CATSDFEVAGSSYNEQFF	GILGFVFTL
CASSLWVAGNGSTF	GILGFVFTL
CASSYQTGTIYGNTF	NLVPMVATV
CASSVGVAGFNEKLFF	GILGFVFTL
CASSLWVENYGYTF	NLVPMVATV
CASRSGTYDNSPLHF	NLVPMVATV
CASSYGGYEQYF	GILGFVFTL
CASSLTGSEQYF	LLFGMPPCL
CASSIFSAGNEQF	GILGFVFTL
CASSLHGELF	NLVPMVATV
CASSPGTGREQF	NLVPMVATV
CASSFTKDYSTMF	GILGFVFTL
CASSFSLPYEQYF	NLVPMVATV
CSARGDTGTGYEQYF	NLVPMVATV
CASSHSSGGMSTEAFF	GILGFVFTL
CSASLKADEQFF	LLWNGPMAV
CASSVGNTEAFF	YVLTWIVGA
CSAPTSGGPNEQFF	LLWNGPMAV
CASSTRAADTQYF	GILGFVFTL
CASSARSAYEQYF	GILGFVFTL
CASSSQGETYEQYF	KLVALGINAV
CASSSGAAYEQYF	LLWNGPMAV
CASSPQDRDFYEQYF	GILGFVFTL
CASSRLSGTGDSPLHF	KMVAVFYTT
CASSQDPGNGNTIYF	VVTGVLVYL
CSSTGTEGYTGELFF	GILGFVFTL
CASSQEVQGGEKLFF	GILGFVFTL
CSARLAGDTGELFF	NLVPMVATV
CASSYGGGSPQYF	VVLSWAPPV
CASSPGQGFVKF	ELAGIGILTV
CATSGQPQETQYF	GILGFVFTL
CASSPLAGGFNEQF	GILGFVFTL
CASSFGQGYEQYF	NLNCCSVPV
CAWSVLTAESGELFF	NLVPMVATV
CASSQDPFAVLNTEAF	NLVPMVATV
CASSPDSDSYEQYF	GILGFVFTL
CASSLTSGSFAGELFF	ELAGIGILTV
CASSPFPSGFTDTQYF	NLVPMVATV
CASSQALPYAQYF	NLVPMVATV
CASSPSSAALELF	NLVPMVATV
CASSSTVYNEQFF	ELAGIGILTV
CASSDRETYEQYF	NLVPMVATV
CASSDSSGYSGANVLTF	NLVPMVATV
CSARPSGGVSAYEQYF	GILGFVFTL
CASSFAHLSYNEQFF	NLVPMVATV
CASSFGVYEQYF	GILGFVFTL
CASSEDRGDTGELFF	GILGFVFTL
CASTVRQGSNQPQHF	LLAILTYYV
CASSQGQGYEQYF	MLNIPSINV
CATSTPNTEAFF	GILGFVFTL
CASSVGVAEAFF	GILGFVFTL
CASSVGGGSNQPQHF	KLWASPLHV
CASSNRASEKLFF	GILGFVFTL
CASTYRDSGNTIYF	KLPLDIDPV
CASRKRGTAPQFF	GILGFVFTL
CSPGDGYTF	NLNCCSVPV
CASRLLAGGRSAQYTF	NLVPMVATV
CASSFGQGADIQYF	GILGFVFTL
CASSQDRREQYF	GILGFVFTL
CASIETESTGELFF	FLNDLLSVL
CAISAGTGVRNEQYF	NLVPMVATV
CASSYGQPNTEAFF	KLSELHTYI
CASSASGGAGNEQFF	GILGFVFTL
CAWRGGQGQIYEQYF	GILGFVFTL
CASTPGTEAFF	KLWASPLHV
CASSPGTPTYGYTF	GILGFVFTL
CASLGLQETQYF	FLTVFSHFM
CASSNLGGTDTQYF	LLFGMTPCL
CASAPGPVYEQYF	KLWASPLHV
CASSVVNEQF	NLVPMVATV
CASRLVQGRAFYEQYF	GILGFVFTL
CASSFTVAGEQYF	ALSPVIPHI
CASSPRSTDTQYF	GILGFVFTL
CASSGSGGFTEAFF	LLAMTVPNV
CASSPYSGANVLTF	YMFLASPSV
CASSGSGASTDTQYF	KMVAVFYNT
CASSWTGAGYEQYF	NLNCCSVPV
CASSQQGSEQYF	NLNCCSVPV
CASSWSGTSYGYTF	NLVPMVATV
CSVEENGNYGYTF	GILGFVFTL
CASTTEGGLIHEKLF	YVLDHLIVV
CVGRKGRDGYPF	GILGFVFTL
CASTQGGVDTQYF	KLFEFLVHGV
CASSLRTNSDTQYF	HIVEISTPV
CASSIRSSYEQFF	GILGFVFTL
CASSPAPAYEQYF	KLWASPLHV
CASSIRSGVEQYF	GILGFVFTL
CASSFWSGGTYEQYF	FIDQYYSSI
CSAPDLFGQGIETQYF	NLVPMVATV
CASSDSYEQYF	LLWNGPMAV
CASSLGGGGLFF	GILGFVFTL
CASSMRSGSEQYF	GILGFVFTL
CASSQDEPYEQYF	GILGFVFTL
CASSRWGQGTRGYTF	NLVPMVATV
CASSLVRDGPYEQYF	GILGFVFTL
CASSQEGQDYGYTF	MMPFSIVYIV
CSVPVFGRGTGELFF	SLLLLSVSV
CASSQGQANEKLFF	LLWNGPMAV
CASSGRSAGELF	GILGFVFTL
CASSSGGTEAFF	NLVPMVATV
CASSTRSGDTQYF	GILGFVFTL
CASSLTTGTGSYGYTF	NLVPMVATV
CASSMTVMNTEAFF	FIDQYYSSI
CASSIFGSYEQYF	GILGFVFTL
CASSILSNQPQHF	GILGFVFTL
CASRLATLVGNEQF	ELAGIGILTV
CASSFLGKSYEQYF	NLVPMVATV
CASVPYGYEQYF	GILGFVFTL
CASSLDPVYRSTEAFF	GILGFVFTL
CASKRMTGEAGQPQHF	RLGPYLEFL
CASSQVGSTEAFF	ELAGIGILTV
CASSQDLPGLYF	GILGFVFTL
CASSEGGYTEAFF	NLNCCSVPV
CASSKIAGGPYTQYF	GILGFVFTL
CASSPEPGSHEQYF	ELAGIGILTV
CASSPSTTLSSGASGETQYF	GILGFVFTL
CAISETSEHYEQYF	NLVPMVATV
CASSIGEGNGQFF	GILGFVFTL
CASSLTSGSPYNEQF	NLVPMVATV
CAWRGAQGYTF	GILGFVFTL
CASSGGSKNYAVF	GILGFVFTL
CASSLAPGATSEKLF	NLVPMVATV
CASSPGQGPYEQYF	LLWNGPMAV
CASSIFSGQPQHF	GILGFVFTL
CSAQSGLAGGSLQETQYF	NLVPMVATV
CASSPAGTDYGYTF	KLNTITPVV
CASSGRSGVEQFF	GILGFVFTL
CASSLQTGVRSYEQYF	NLVPMVATV
CSAREEGTQAWETQYF	NLVPMVATV
CASRASGLASNEQFF	NLVPMVATV
CASSLQSVDANGYTF	GILGFVFTL
CASSTGAYGYTF	GILGFVFTL
CASSWLNTEAFF	FMLYLLTLM
CASSPSPGSEQYF	LLFGMTPCL
CASSQHYTGENTEAFF	GILGFVFTL
WASSFQGFTEAF	NLVPMVATV
CSVSGERGTDTQYF	LLWNGPMAV
CASSFGPSYGYTF	VVMSWAPPV
CASSAGQESYEQYF	LLWNGPMAV
CASSLYVYSYEQYF	NLFNRYPAL
CASSPTGTGYNEQFF	FMYSDFHFI
CASSSLRGSNQPQHF	YVLDHLIVV
CASGRAGGPGNEQSF	GILGFVFTL
CASSVDGTEETQYF	FLMASISSS
CASSQAGEQYF	LLAILTYYV
CASSGTGVSPLHF	LLWNGPMAV
CAWSGVSYEQYF	GILGFVFTL
CASSKQTGTIGGYTF	NLVPMVATV
CASSWRRGTDTQYF	ALYGFVPVL
CSARDRLGEQYF	GILGFVFTL
CASSQDISRGQTLFGNSPLHF	NLVPMVATV
CSVATSGGSNEQFF	LLWNGPMAV
CASSVGVSGSFYEQYF	MLNIPSINV
CASSPGQSPTNEKLFF	ELAGIGILTV
CASRRQIAGQPQHF	GILGFVFTL
CAWSSGLGNEKLFF	GILGFVFTL
CASSAGLFPEQFF	GLSPNLNRFL
CATSGGTSYEQFF	LLWNGPMAV
CASSLGGGSYEQYF	NLVPMVATV
CASSFSAREYGYTF	ALVGAIPSI
CASSPGRTQYF	FLYNLLTRV
CSARGGVYNEQFF	GILGFVFTL
CSSSLTGSGQPQHF	YVLDHLIVV
CASMNDGATYEQYF	NLVPMVATV
CSVTQGDGTDTQYF	NLNCCSVPV
CASSIGGYGYTF	FLYNPLTRV
CASRPGGGGYTF	IMDQVPFSV
CASSLGLAATYNEQF	NLVPMVATV
CASSFPVSDPSTDTQYF	KMVAVFYTT
CASSIRSSYGQYF	GILGFVFTL
CASTYTSLAHNEQF	ELAGIGILTV
CASSSGTGNSGELFF	GILGFVFTL
CASIIRSSYEQYF	GILGFVFTL
CASSQDQNTEAFF	LLFGMTPCL
CAIPGRGTANQPQHF	GILGFVFTL
CASSITWMNTEAFF	KMVAVFYTT
CASSLFSIGEQFF	GILGFVFTL
CASSQEAGGGTGELFF	LLWNGPMAV
CSARDLGGTAKNIQYF	NLVPMVATV
CASSRGQGSADTQYF	YVLDHLIVV
CASSVKAGGNEQYF	LLWNGPMAV
CSATEAGGPGNEQFF	LLWNGPMAV
CASSSLGDSYEQYF	LLFGMTPCL
CASSKRSTGELFF	GILGFVFTL
CASSEVRGPWAETQYF	SLPITVYYA
CSARDGLMEGAGELFF	GILGFVFTL
CASSPGTGAYEQYF	LLWNGPMAV
CASSYETGGSYEQYF	ELAGIGILTV
CASSVRAGETQYF	GILGFVFTL
CASSQEPSGFYEQYF	NLNCCSVPV
CASSFQGYTEAFF	NLVPMVATV
CASRRQATNEKLFF	VMPFSIVYIV
CASSLSWEDENTDTQYF	KMVAVFYTT
CASSRKGDSPLHF	RLGPYLEFL
CASSIGVYGYTF	GILGFVFTL
CASSIRSAHEQYF	GILGFVFTL
CSARGDPNYEQYF	ILTGLNYEA
CASSARDFAYEQYF	GILGFVFTL
CASSIRPSYEQYF	GILGFVFTL
CASREPSGRADEQFF	NLVPMVATV
CASGGLSYGYTF	LLSIIFFPA
CASSLFNQETQYF	YVLDHLIVV
CASSFMETQYF	ALSPVIPHI
CASSSDPSGGGYNEQFF	NLVPMVATV
CASSQGPGARQPQHF	GILGFVFTL
CASSDGNEQFF	NLFNRYLAL
CASSDSRTPFQRPLFEAFF	GILGFVFTL
CASSLGGAPYNEQFF	LLWNGPMAV
CASSETSINEQF	GILGFVFTL
CASGDLSYEQYF	KLMNIQQQL
CASSPSGGAYGYTF	LLWNGPMAV
CASSQATGYEQYF	KLWASPLHV
CAPLKGSSYEQYF	GILGFVFTL
CASSLGWGLLSYNEQF	NLVPMVATV
CASRRRVDNEQFF	GILGFVFTL
CSASGDRGADTQYF	LLWNGPMAV
CASSLGGTEAFF	KMVAVFYTT
CASSPRSADTQYF	GILGFVFTL
CAWSVQGLGYGYTF	ELAGIGILTV
CASSPLIGEQYF	GILGFVFTL
CASSHETGELFF	YVLTWIVGA
CASSKGEVTEAFF	NLVPMVATV
CASSLAGVGEQFF	GILGFVFTL
CSARVRGDHNEQFF	LLAILPYYV
CASSHLQGGQYNEQFF	GILGFVFTL
CASSYGGISYGYTF	NLNCCSVPV
CASSSFYTDTQYF	GILGFVFTL
CATGLGGVSSPLHF	RLGPYLEFL
CASSPGISVNYGYTF	GILGFVFTL
CASSLWDPGELFF	NLVPMVATV
CASSSRTSGINEQFF	NLVPMVATV
CASSQGQGLNGYTF	NLVPMVATV
CASSYSSDRSSYEQYF	ALSPVIPLI
CSATDVTKGQLISGYTF	NLVPMVATV
CASSQSTGSSYEQYF	GILGFVFTL
CAISEPGTGDTEAFF	LLFGYPVYV
CASSSKLADQETQYF	GILGFVFTL
CASSLVGGRYGYTF	NLVPMVATV
CASSTRSGWIQYF	GILGFVFTL
CASSQVTSTDTQYF	NLVPMVATV
CASSVYSNQPQHFT	GILGFVFTL
CASSYNVRDGDYGYTF	GILGFVFTL
CASSNGAYGYTF	GILGFVFTL
CASSYSIGNTEAFF	ELAGIGILTV
CASSQGLAGAGELF	ELAGIGILTV
CASSVYSTDTQYF	RLGPYLEFL
CASSVDGGGGGYNEQFF	LLWNGPMAV
CASSYGAGTGELF	GILGFVFTL
CASSTSLLAGNNEQF	NLVPMVATV
CASSDTDRGIYGYTF	LLWNGPMAV
CASSFGSGAPGELFF	NLVPMVATV
CASSYTGGLMAFF	GILGFVFTL
CASSLGQGTYEQYF	LLFALHFSA
CAISEAGPGSANTEAFF	FMLYLLTLM
CASSLGQGDFGETQYF	MLMLAVIVA
CASSLLGVGEKLFF	GILGFVFTL
CASSTFGANVLTF	GILGFVFTL
CASNSSGTGAYEQYF	GILGFVFTL
CASSQRSTDTQYF	GILGFVFTL
CASSDDIVTDTQYF	FLYNLLTRV
CASSLGTSYEQYF	GILGFVFTL
CAWSGSDTQYF	GILGFVFTL
CASAKGYGYTF	GILGFVFTL
CASSFFASGDTDTQYF	KMVAVFYTT
CASSSWTGWYEQYF	VLNYFEPYL
CASTKTGLGDQPQHF	GLTSFFIAI
CSAHPRDVQETQYF	KMVAVFYTT
CASTRQGAYEQYF	LLWNGPMAV
CASIPDRGSGNTIYF	GILGFVFTL
CASSSPSQGITGELFF	LLAILPYYV
CSAPYRVEGRIVNEQYF	GILGFVFTL
CASSALGGGGTGELF	NLVPMVATV
CAWSVAGSTDTQYF	GILGFVFTL
CASSIYSGVGNEQFF	GILGFVFTL
CASSPGQGYEQYF	FLFMYLVTV
CASSGLAGFSPQETQYF	YLQQNWWTL
CASSLGTGHNEQFF	GILGFVFTL
CASSIRSGWEQYF	GILGFVFTL
CASSEWDTEAFF	NLFNRYPAL
CASSVGSGTEAFF	GILGFVFTL
CAWSWTVNTEAFF	FLTVFSHFM
CASSQGPGTGFEGYTF	LLSIIFFPA
CASSTDTNEQFF	GILGFVFTL
CASSTTGTGLLEQYF	ELAGIGILTV
CASIQDRDRPNSPLHF	FLASPSVPL
CSARDGLTGHYEQYF	NLVPMVATV
CASSFGQAWYEQYF	NLVPMVATV
CARRSRGENNGGVF	GILGFVFTL
CSARSEKSGANVLTF	RLVPYLEFL
CASSWVVPPNEQFF	GILGFVFTL
CASSSNIIRGSSYEQYF	GILGFVFTL
CSAIPTGNYEQYF	GILGFVFTL
CASSLGHFEGNQPQHF	KMVAVFYTT
CSAREVYEQFF	GILGFVFTL
CASGQASSYNSPLHF	RLGPYLEFL
CASSLASGGALYNEQFF	LLWNGPMAV
CASTPGTGAYEQYF	LLWNGPMAV
CASSLRSGTEDTDTQYF	GILGFVFTL
CASSLYFWLAESEQYF	LLSIISFPA
CASSSLSGLYEQYF	GILGFVFTL
CASSQVGGPDTQYF	GILGFVFTL
CASSYLTGMNQPQHF	GILGFVFTL
CATSISGTSGSDEQFF	GILGFVFTL
CASSREPNPNYGYTF	GILGFVFTL
CSVVLVDRGADTQYF	LLWNGPMAV
CASSIMAYNGQFF	GILGFVFTL
CSARYGSTCEQYF	NLVPMVATV
CASSQRSSTEAFF	GILGFVFTL
CASSLWGTYNEQFF	MMPFSIVYI
CASSELGGYNEELFF	GILGFVFTL
CASSFGASYGYTF	LLWNGPMAV
CASRPNEGPYEQYF	GILGFVFTL
CASSLGEDYEQYF	NLNCCSVPV
CASSKGTANTEAFF	NLVPMVATV
CASMPRGFPSDEQFF	ELAGIGILTV
CASSQTLVADTQYF	ELAGIGILTV
CASSQGKDTQYF	NLVPMVATV
CASSYFRDRVGDQPQHF	NLVPMVATV
CASSLGNGGWAEAFF	AVGSYVYSV
CATRRGEGQEKKQPQHF	NLVPMVATV
CASSAGTIYNEQFF	RLGPYLEFL
CASSYGLAEQFF	GILGFVFTL
CASSVVASSYNEQFF	GILGFVFTL
CASSLTGSAEAFF	MMPFSIVYI
CSVAGGTEAFF	FMLYLLTLM
CASRGTGTGSYEQYF	KLSREIMPV
CASSYGHPGEQYF	KMVAVFYTT
CSARTDRGNNYGYTF	NLNCCSVPV
CSARDGGLAGEQKVGDTQYF	LLFGYPVYV
CASSFTSGDTQYF	ELAGIGILTV
CAGSPFGGAYEQYF	GILGFVFTL
CASSFEGQETQYF	KLVALGINAV
CASSQAGAYEQYF	LLWNGPMAV
CASSLGAGSYEQYF	VLFHRAFLV
CASSIRASNEQFF	GILGFVFTL
CASSPKDTQYF	GILGFVFTL
CSATLDRNYGYTF	LLAGTLAVV
CASDSGSGQPQHF	LLFGMPPCL
CASSQTGFGNQPQHF	NLVPMVATV
CASTQGKAKGYEQYF	GILGFVFTL
CSARNRASYNSPLHF	TAMDLFVTV
CASSYGTGQPQHF	ELAGIGILTV
CASRKRSSEAQYF	GILGFVFTL
CASTPGELAGGGETQYF	NLVPMVATV
CANSYATGIGNYGYTF	NLVPMVATV
CASSYPQGHYKAFF	GILGFVFTL
CASSETGGNQPQHF	NLVPMVATV
CASSTKDGGTGELFF	GILGFVFTL
CASSRQPMNTEAFF	ALYGFVPVL
CASRIDSNQPQHF	GILGFVFTL
CASSPSGGVYGYTF	KLWASPLHV
CASSLFVGGPGNEQF	NLVPMVATV
CASSPRQGGKQPQHF	NLVPMVATV
CASSMRSSGEQYF	GILGFVFTL
CASSLGNEQFF	NLVPMVATV
CASSGRDRNF	LLSIIFFPA
CASSLEQFLSGPAETQYF	KMVAVFYTT
CASSPSSGGITDTQYF	ILTGLNYEV
CASSEVGATNYGYTF	NLVPMVATV
CASSQDGQGVFETQYF	LLAMTVPNV
CASGGLVHEQFF	GILGFVFTL
CASSPQGQGESGANVLTF	MLNIPSINV
CASSSPGENYNEQFF	GILGFVFTL
CASSSLSADTQYF	GILGFVFTL
CASSVEGSTEAFF	AVGSYVYSV
CASSFPKDGSTYEQYF	NLVPMVATV
CASSQEEGPGNQPQHF	RLGPYLEFL
CASSIGLWGYTF	GILGFVFTL
CASNSGGAYNEQFF	FLTYLDVSV
CAWIPGTGGAGGLF	NLVPMVATV
CASSLREGNTEAF	NLVPMVATV
CASSSSGIGETQYF	VVMSWAPPV
CASSLLGFSTETQYF	GILGFVFTL
CASSWREGFPYEQYF	KLLAGVEIV
CASSLYPGTAEGGYTF	LLWNGPMAV
CASSQGGQDGHGTTNEKLFF	VLASPSVPL
CASSIEFDRGAPTEQYF	ELAGIGILTV
CASSDKFAGNPQPQHF	LLWNGPMAV
CAWSAGGTGELFF	KLMNIQQKL
CASSVTSDQTQYF	TMAAISNTV
CASSLPDNNEQFF	KMVAVFYTT
CASSQTGSTDTQYF	GILGFVFTL
CASSTGNYGYTF	ALYGFVPVL
CASSRIANNNNEQFF	VLNYFEPYL
CASSLGWGYEQYF	MLNIPSINV
CASSFNYNEQFF	FVYVFTTHL
CASNTGYQETQYF	FMLYLLTLM
CASSQDTGYEQYF	FLYNLLTRV
CASGKGDTEAFF	KLMNIQQQL
CASSYSSGYFLFF	NLNCCSVPV
CASSPITNTGELFF	KMVAVFYTT
CASSVVGAADTQYF	NLVPMVATV
CSAARGHYGYTF	NLVPMVATV
CASSSQGGAKNEQYF	ILNVDIFTL
CASSRTATHGYTF	GILGFVFTL
CASSQGTSRDRNQPQHF	VMPFSIVYIV
CASSLAGGTEAFF	LLLNMLIVL
CASSTTSGGVETQYF	GILGFVFTL
CASSTKVGGTGELFF	GILGFVFTL
CASSYSEGTEAFF	NLVPMVATV
CAIKTTSGIVDEQF	NLVPMVATV
CASSIISTDTQYF	GILGFVFTL
CASSLGTLNEQFF	ALSPVIPLI
CATSDLHRGDEQFF	NLVPMVATV
CAWSVSSYEQYF	GILGFVFTL
CSVEYRDNEQFF	NLVPMVATV
CASSVGLHGQPTNEKLFF	NLVPMVATV
CASSLAAQGQRVTGELFF	KMVAVFYTT
CASSEGQNTEAFF	ILTGLNYEA
CASGTGTPYNEQFF	LLWNGPMAV
CASSNQETQYF	ALYGFVPVL
CASSEPGPGRDGYTF	GILGFVFTL
CASSPRQGPVEKLFF	GILGFVFTL
CASPPLGGGYNEQFF	GILGFVFTL
CASSFSGTANTEAFF	GILGFVFTL
CASSTGLYGYPF	GILGFVFTL
CASSVGGGREQFF	LLWNGPMAV
CASSGQGAYITDTQYF	ALSPVIPLI
CASSQGNEQFF	GILGFVFTL
CASSQAGGYEQYF	NLNCCSVPV
CASSVRTGYTEAFF	GILGFVFTL
CSATPRYRGYEQYF	VVLSWAPPV
CSVDRRADEQFF	LLWNGPMAV
CASSYFPLADTQYF	NLVPMVATV
CASSQEGRQGSYNEQFF	VLNPFIYML
CASSSRSTGELFF	GILGFVFTL
CASRPPPAGQKETQYF	GILGFVFTL
CASTIVSGYTF	NLVPMVATV
CASSPSGLAGLTDTQYF	GILGFVFTL
CSVTGERGTDTQYF	LLWNGPMAV
CATLKQGAMDWETQYF	NLVPMVATV
CASSVEGALTDTQYF	YLDELIRNT
CASSYATGIGNYGYTF	NLVPMVATV
CAWSSRDSMTDTQYF	NLVPMVATV
CATSRDRLAGGIHEQYF	GILGFVFTL
CASSGRSLEEQYF	GILGFVFTL
CSATPWVGLSFSNQPQHF	NLVPMVATV
CASSEIASYNEQFF	FILDAVQRV
CASSVEGTSGRSYNEQFF	NLVPMVATV
CASSQVGGSYPREQFF	ALSPVIPHI
CASSLVANEQF	NLVPMVATV
CASSSAGLPEQYF	ILNAMIAKI
CATSPRGGHEQYF	LLWNGPMAV
CASSLQGNYGYTF	GILGFVFTL
CASSYGGNSPLHF	VVLSWAPPV
CAKKTSLLGPGANYGYTF	VLFGLGFAI
CASSSRSTDTQYF	GILGFVFTL
CASSIAAVSALYGYTLF	ELAGIGILTV
CSVRTNEFYEQYF	GILGFVFTL
CASSPLAGYTGELF	ELAGIGILTV
CSAGEDWHEQYF	GILGFVFTL
CSAPTSGPYNEQFF	GILGFVFTL
CAWGVLFIGRGVGDYGYTF	GILGFVFTL
CASSYRVTEAFF	GILGFVFTL
CASSRDGPSSYEQYF	ILNAMIAKI
CASSFQGFTEAF	NLVPMVATV
CSVQGGSTEAF	NLVPMVATV
CASSENTGELFF	SVLENFTILL
CASSYGTGSSEQYF	GILGFVFTL
CASSLVGGITGELFF	VVTGVLVYL
CSASDSLTISGFF	SLAPLSPRV
CASSQGTGGIVDIQYF	SLAPLSPRA
CASSTSLGGGGRQSF	GILGFVFTL
CASSVEGAHPIQETQYF	AVGSYVYSV
CASSESFPASGGSTDTQYF	MLNIPSINV
CASSILGKDTQYF	GILGFVFTL
CASSYGPEAHNEQFF	NLVPMVATV
CASSSPWGGTTDTSTDTQYF	KMVAVFYTT
CSARGGTDGYTF	ILNVDIFTL
CASSIRSSEEQYF	GILGFVFTL
CASSRTSDTQYF	GILGFVFTL
CASSPYSNQPQHF	NLNCCSVPV
CASSLSTSGSSYNEQF	NLVPMVATV
CSVEDISGYNEQYF	GILGFVFTL
CASRGRSSYEQYF	GILGFVFTL
CASSFLSADTQYF	GILGFVFTL
CASSYSSDFWGDQPQHF	VVLSWAPPV
CASSLPPGRGYTEAFF	NLVPMVATV
CASTHWERVDEQFF	VLNPFIYTL
CASSYSGQGYTF	ALYGFVPVL
CASSFSGTFEAFF	ALSPVIPHI
CASSMTSGALYNEQFF	NLVPMVATV
CASSVDAGGYNEQFF	NLVPMVATV
CASSESSSTGGKWDTQYF	FLNDLLSVL
CASNQGLYEQYF	NLNCCSVPV
CASSPRASLEQYF	GILGFVFTL
CAWSVLGSTDTQYF	GILGFVFTL
CATSDSRQINTGELF	ELAGIGILTV
CATSRDLGGQQPQHF	ILTGLNYEV
CSARGAGFSGANVLTF	YVLDHLIVV
CASSLTGSSDTQYF	FSFPLDFLV
CASSPITGTGAYGYTF	NLVPMVATV
CASGGTGEYEQYF	FMIGYTSAL
CASSQDTGMGNQPQHF	GILGFVFTL
CASSSVNEQF	NLVPMVATV
CASSPTTRTRYYGYTF	NLVPMVATV
CASSYADGLEQYF	ILNAMIAKI
CSVDGDSVAFF	GILGFVFTL
CASSSPGGETQYF	ELAGIGILTV
CASSSSGTAYGYTF	LLWNGPMAV
CASSSSNQPQHF	GILGFVFTL
CASSGRSPYEQDF	GILGFVFTL
CASSVGSGGRPSSYNEQFF	IMDQVPFSV
CASSHRGYEQYF	LLWNGPMAV
CSAPDTGLGQPQHF	ELAGIGILTV
CSVEGVRKTNTGELFF	NLVPMVATV
CASSLSSVNEATF	NLVPMVATV
CASSLGQGAEQF	ELAGIGILTV
CATSQGSYGYTF	GILGFVFTL
CASSENQLNMTEAF	ELAGIGILTV
CASSHSWGETQYF	YLLFMIGYA
CASSTRSSSPQHFT	GILGFVFTL
CASSYGYPAYEQYF	GILGFVFTL
CANSSHRGEAAFF	GILGFVFTL
CASTEQGGFAEAFF	GILGFVFTL
CASSLQTGATFNYGYTF	NLVPMVATV
CASSGYSVDTQYF	GILGFVFTL
CATTGGSGYEQYF	LLWNGPMAV
CASSYSSSGGAYEQYF	LLWNGPMAV
CASSQGGQGYEQYF	GILGFVFTL
CASSYSATGGEQYF	ELAGIGILTV
CASRAGIQSGELFF	ELAGIGILTV
CASGSIEETQYF	GILGFVFTL
CASTPDSEIYEQYF	GILGFVFTL
CASSASGRYNEQF	GILGFVFTL
CASSYRQENTEAF	NLVPMVATV
CASSLGAEQYF	LLFGMTPCL
CASSHGQGAYEQYF	LLWNGPMAV
CASSQGAYGYTF	GILGFVFTL
CASSQRTGGADGYTF	GILGFVFTL
CAISDRFMREEMTYGYPF	VLFGLGFAI
CASSATGTVNTEAFF	RLGPYLEFL
CASSQRMGLSETQYF	NLVPMVATV
CASSTRSADTQYF	GILGFVFTL
CASSPWEMNTEAFF	KMVAVFYTT
CSVEISGKEDTQYF	GILGFVFTL
CSARVWDSYEQYF	GILGFVFTL
CASSYSGGLDTEAFF	GILGFVFTL
CASSPIAGSSYEQYF	GILGFVFTL
CASSPEGVSYEQYF	GILGFVFTL
CASSLSSGPYNEQFF	VVLSWAPPV
CASSVAGGAYEQYF	LLWNGPMAV
CASSAGSGSGYNEQFF	NLVPMVATV
CASKSLETGFNQPQHF	NLVPMVATV
CASSQADRAVYGYTF	NLVPMVATV
CASSLIDSPYEQYF	VLNYFKPYL
CASSPSGGSYGYTF	NLNCCSVPV
CASSQTGTGAYEQYF	LLWNGPMAV
CSAGVYEQYF	NLNCCSVPV
CASSLYGELYYGYTF	SLLWMNPFV
CASSIRAADTQYF	GILGFVFTL
CASSAYLGAGELFF	GILGFVFTL
CASSLAAGGGETQYF	RLWEPLRVV
CSGGRGEETQYF	NLVPMVATV
CAWSVSDIMNTEAF	NLVPMVATV
CASSQDPGYEQYF	GILGFVFTL
CATRDSQSSYEQYF	KLFEFLVYGV
CASGGGGAEAFF	NLVPMVATV
CASTRQFNQPQHF	LLWNGPMAV
CASSLTSGNEQFF	GILGFVFTL
CASSFGGYEQYF	KLVALGINAV
CASSLLGGAGTDTQYF	GILGFVFTL
CASSLETSDGETQYF	GILGFVFTL
CASSPGTAYEQYF	KLWASPLHV
CASSIGLNTEAFF	FLNVLFPLL
CASSKSSYEQYF	GILGFVFTL
CASCLGQGSYNEQFF	GILGFVFTL
CASSRSRWEFYGYTF	ILTGLNYEV
CSVEGLAGRGYNEQFF	LLIASVTWL
CASSQGSYGYTF	GILGFVFTL
CASSQDGFAYEQYF	GILGFVFTL
CASSPDPSGNEQFF	TMSFSHLFYL
CASSPSAGDYEQYF	LLWNGPMAV
CASSYSGGYEQYF	NLNCCSVPV
CASLSPIRDRGTGELF	NLVPMVATV
CASSSRLSSGYTF	VVMSWAPPV
CSARGGDSVLRVGEQYF	GILGFVFTL
CSARDYRGGTTYEQYF	GILGFVFTL
CASSIRAGYEQF	GILGFVFTL
CSAPYRVEGRIVNEQFF	GILGFVFTL
CASSVAGGSGNTIYF	FLSDHLYLV
CASSVRSSYEQYF	GILGFVFTL
CSARISTSSSYEQYF	VVLSWAPPV
CASSVETTDYGYTF	KLVALGINAV
CASSMRSYNEQFF	GILGFVFTL
CASSHDDRGPNEKLFF	AMAGSPVFL
CSVEKGTATLEQYF	GILGFVFTL
CASSYYSNQPQHF	GILGFVFTL
CASSWDYTEQYF	YLLPAIVHI
CASSYRGSVYNSPLHF	GILGFVFTL
CASSDAGFRTQYF	NLVPMVATV
CSASPRTGGIYEQYF	GILGFVFTL
CASSSFGTDTQYF	GILGFVFTL
CASSLAQVDQYF	NLVPMVATV
CASSQGISTGELFF	VLNPFIYTL
CSATHRLAGQIYNEQFF	GILGFVFTL
CASSALGINEQFF	ELAGIGILTV
CASSIHGANQPQHF	GILGFVFTL
CASSLVRADGETQYF	KMVAVFYTT
CASSPSTGVTFYGYTF	NLVPMVATV
CSARDPGETGYEQFF	GILGFVFTL
CASSLVVLAYGTDTQYF	GILGFVFTL
CASSLAGEVNEQFF	GILGFVFTL
CASSQGTINTGELFF	ELAGIGILTV
CASSQDLPGPNTEAFF	GILGFVFTL
CASSLGRINEQFF	GILGFVFTL
CASSYSEVTEAFF	GILGFVFTL
CASSADGMNTEAF	NLVPMVATV
CASSQGSGLAGYEQYF	GILGFVFTL
CASSPSGSGTGTYEQYF	KMVAVFYTT
CASSYFRQSYEQYF	ILLDWAANV
CATQWTGGHEQYF	RLHDLVLPL
CASSPTSGGYEQYF	KLNTITPVV
CASSYSLEGYTF	ALSPVIPHI
CASSIRNSYNEQF	GILGFVFTL
CASSPTPGTGETQYF	AMAGSLVFL
CASSLEGEKLFF	LLSIIFFPA
CATSDYVSGTLQETQYF	GILGFVFTL
CASSDRAGNEQFF	GILGFVFTL
CASSYTLPGTVPQRNQPQHF	GILGFVFTL
CASSLAGNYGYTF	GILGFVFTL
CASSPWRGPFQETQYF	SIIGRLLEV
CSATCNGTFLYQETQYF	ALSPVIPLI
CSAREGLAAGELFF	NLNCCSVPV
CSAFDREGVDGYTF	NLVPMVATV
CSASFSDTQYF	NLVPMVATV
WASSQALPYEQYF	NLVPMVATV
CASSFRESYEQYF	ELAGIGILTV
CSAAGLAGGSYEQYF	GILGFVFTL
CASSMSGWGDTQYF	ILNAMIAKI
CASSVLGVADTQYF	GILGFVFTL
CASSGGSKKTQF	GILGFVFTL
CASSLVDSGLYEQYF	KLVALGINAV
CASSPRDRVHEQYF	ALIHHNTHL
CASSLREAGELFF	FLYNPLTRV
CSASSDESSYNEQFF	GILGFVFTL
CSVASGTGTNTEAFF	GILGFVFTL
CASSYGTGYEAFF	KLWASPLHV
CSATWEQSGNGETQYF	NLVPMVATV
CASSYGIAGKETQYF	GILGFVFTL
CASSFRSTDTQYF	GILGFVFTL
CAWSVSGLGYGYTF	ELAGIGILTV
CASSIGYEQFF	GILGFVFTL
CASSKGLRQFF	FIFSYVVAV
CASSLLPGRNTEAFF	GILGFVFTL
CASSPRSGETQYF	GILGFVFTL
CASSSGFVGPYQPQHF	GILGFVFTL
CASSPHEAAEQYF	GILGFVFTL
CASSMFALDTQYF	GILGFVFTL
CASSRGTGGYEQFF	MLNIPSINV
CASSLGNTEAFF	FLYNPLTRV
CASRPGQVVYGYTF	MMPFSIVYIV
CASSIYGGSYNEQFF	GILGFVFTL
CASGDGLAGKITGELFF	VLFGLGFAI
CASSIQGALTDTQYF	LMFWASSSI
CATSDRTSATEAFF	NLVPMVATV
CASSGQGAYEQYF	LLWNGPMAV
CASSQLGNEQFF	LLWNGPMAV
CASSYSSGTEAFF	ALYGSVPVL
CASSPDRAITEAFF	GILGFVFTL
CASSLDKPGYTEAFF	GILGFVFTL
CASSSRSRQYRGSSYEQYF	GILGFVFTL
CASRTGYTEAFF	NLVPMVATV
CASSIFGGAREQFF	GILGFVFTL
CASSVETGGLDTQYF	VVLSWAPPV
CASSTRAAGELF	GILGFVFTL
CSARPVQGINYGYTF	NLVPMVATV
CASRLHGGTPSYEQYF	ALSPVIPHI
CASSQEDRGPYGYTF	GILGFVFTL
CASSFSGQNTEAFF	GILGFVFTL
CSARDSLAGAYEQYF	GILGFVFTL
CASSLTNEQF	NLVPMVATV
CASSPTGPAYEQYF	LLWNGPMAV
CSALHGSVGLNQPQHF	GILGFVFTL
CSVPTEGIYGYTF	GILGFVFTL
CASSLAESVYEQFF	GILGFVFTL
CASSAGQGYEQYF	KLWASPLHV
CASTEMGREGYNEQFF	GILGFVFTL
CASSASGDTGELFF	GILGFVFTL
CASFRGHEQF	NLVPMVATV
CASRNRDPNGYTF	KLLAGVEIV
CASSYSRSDGHLGNTIYF	NLVPMVATV
CASILGLTTYNEQFF	AVGSYVYSV
CASSNLPGTGEAFF	NLVPMVATV
CASSDSRQGAFRRETQYF	GILGFVFTL
CSVEENTGTGAIYEQYF	GILGFVFTL
CASSLSRRGPNYGYTF	GILGFVFTL
CASSYVASGSSNYGYTF	GILGFVFTL
CASSLGDNGGYEQYF	GILGFVFTL
CASSRRSTQPQHF	GILGFVFTL
CASSPPDQVYNEQFF	SLLQGSPHV
CSAIVFSRGGDEQFF	FLFTFFASI
CASSPGDGTEAFF	NLNCCSVPV
CASSGRTSGRPDTQYF	GILGFVFTL
GASSQALPYEQYF	NLVPMVATV
CATPKGEASTEAFF	GILGFVFTL
CASSNGQNAYEQYF	LLWNGPMAV
CASSQRASYEQYF	GILGFVFTL
CSVDTGSPGYGYTF	GILGFVFTL
CASSLAVGETRNSPLHF	KMVAVFYTT
CSASGARGADTQYF	LLWNGPMAV
CASSYLAGSGNEQYF	GILGFVFTL
CASKHASGELFF	GILGFVFTL
CASSIKANTEAFF	GILGFVFTL
CASSLNGGSSYNEQFF	GILGFVFTL
CASSLQGGYGGGYTF	ELAGIGILTV
CASSAGGNTIYF	FMIGYTSAL
CASSVGSQETQYF	ILTGLNYEV
CASSWTGGGQPQHF	ELAGIGILTV
CASSYFGSQSEQYF	NLVPMVATV
CASSFPRTATDLYF	GILGFVFTL
CASSVAGSATGELF	NLVPMVATV
CASSRDGFEKLFF	AVGSYVYSV
CASSLEGFTEAF	NLVPMVATV
CASSPGGAAGYTF	GILGFVFTL
CASSIRSNTEAF	GILGFVFTL
CASSQQGVWGTGELFF	WLSLLVPFV
CASSDPDRAVTEAF	NLVPMVATV
CASSYVRASYGYTF	LLWNGPMAV
CASSVADNPYNEQFF	NLVPMVATV
CASSTRSGTEQYF	GILGFVFTL
CASREGYEQFF	NLVPMVATV
CAISDMSWEQYF	NLVPMVATV
CASSTIEGQGGRHTQYF	GILGFVFTL
CSARDRGFFRPGELFF	FIYQYYSSI
CASSYFGGNTEAF	NLVPMVATV
CASSLWGGTEAFF	GILGFVFTL
CASSYSSSYNEQFF	GILGFVFTL
CAISESKGNYGYTF	KLLAGDEIV
CASSLAGYEQYF	NLVPMVATV
CASSYSSRVNYEQYF	NLNCCSVPV
CASSLLGNTEAFF	MLYQHLLPL
CASSVGGVSYNEQFF	LLWNGPMAV
CASSEEYNEQFF	GILGFVFTL
CASSLGTGPYNEQFF	GILGFVFTL
CASSESPGYGYTF	LLWNGPMAV
CASSIDRTVGNTIYF	TMSFSHLFYL
CASSAGASIEQYF	LLFGYPVYV
CSARTTYGTDIISQHF	NLVPMVATV
CASSQGQGSLQYF	FLIYLDVSV
CASSALAGGQADTQYF	LLGATCMFV
CASSVRSTGALF	GILGFVFTL
CASSQDWATVYEQYF	GILGFVFTL
CSPGTSYGYTF	GILGFVFTL
CASGLVPEGLVYEQYF	GILGFVFTL
CASSYQTGAIYGYTF	NLVPMVATV
CASSEALVLEQFF	GILGFVFTL
CATSDWAGEMETQYF	YVLDHLIVV
CASSESTIVQGYNEQFF	LLIDLTSFLL
CAVRLGGARLMF	GILGFVFTL
CSVETGQTQETQYF	GILGFVFTL
CASSDPNDYEQYF	NLNCCSVPV
CASSDPGSGAYEQYF	ELAGIGILTV
CASSLGDNYEQYF	ELAGIGILTV
CSASTGLTEAFF	ELAGIGILTV
CASSITGGEGGELF	GILGFVFTL
CASSVEDYGSVSYGYTF	GILGFVFTL
CASSIRSAYEQFF	GILGFVFTL
CASIGVSYEQYF	MLSILALVRV
CAWSPGQGGETQYF	GILGFVFTL
CASSDSYEQYF	ELAGIGILTV
CSVPEGNTGELFF	ALYGSVPVL
CASSGRQGSYEQYF	LLAMTVPNV
CASSLVESEQFF	MLNIPSINV
CASSAGGGSYNEQFF	NLVPMVATV
CASSQESGTATEAFF	GILGFVFTL
CASSPWGQTASSYNEQYF	GILGFVFTL
CASPPLSGTGHVRGYTF	GILGFVFTL
CASSEKPDTQYF	LLAGTLAVV
CAVNGGSNYGYTF	NLVPMVATV
CASSSPGDYTYEQYF	YVLDHLIVV
CASTHLRDKTFF	GILGFVFTL
CASGIGGNGYPF	GILGFVFTL
CASSMAGSSYEQYF	GMGPLLAMV
CASSSLGGYEQYF	FMLYLLTLM
CASRGSLNQPQHF	GILGFVFTL
CASSQVPGGYEQYF	NLNCCSVPV
CSAISGSGGVGDTQYF	GILGFVFTL
CASSIYSTPDQPQHF	GILGFVFTL
CASSPAGSNYGYTF	FLYNPLTRV
CASSPDREGTDTQYF	NLVPMVATV
CASSAAGQELGYTF	VLNPFIYTL
CASSLDLDWGQSYNEQFF	VVMSWAPPV
CASSQTIGTGFSNEQFF	WLSLLVPFV
CASSDYSNQPQHF	ELAGIGILTV
CASSEGLGWEQFF	FLIYLDVSV
CASSRSPGGVYEQYF	ELAGIGILTV
CSARDRWNSLGEQYF	GILGFVFTL
CASSIRAGYEQYF	GILGFVFTL
CASSEAEAGAYTQYF	LLSIIFFPA
CASSQDWVAEQYF	ELAGIGILTV
CSGLVPGFDSPLHF	VVLSWAPPV
CATSRAGAYEQYF	LLWNGPMAV
CSVRTIYEEQYF	GILGFVFTL
CASSYPIQGTSNQPQHF	GILGFVFTL
CAWRDRVGHQPQHF	GILGFVFTL
CAGMTVTEAFF	GLYDGMEHL
CASSLEGQGAPGQPQHF	LLWNGPMAV
CASSFMGQGESGYTF	LLSIIFFPA
CASSLTGLLNTEAFF	LVMPFSIVYI
CASSGLAGGPFGMETQYF	KLVALGINAV
CASSTKEGGTGELFF	GILGFVFTL
CASSQEWAQGYEQYF	GILGFVFTL
CASSPGTLKETQYF	NLVPMVATV
CASSIYGGNEQFF	GILGFVFTL
CASSIRSTDTQYF	GILGFVFTL
CASSPDSDAYEQYF	GILGFVFTL
CASSAGDTEAFF	GLTSFFIAI
CASSLGFGYEQFF	MLNIPSINV
CASSYQTGAAYGYTF	NLVPMVATV
CASRSSDPYEQYF	GILGFVFTL
CASYFFALFTDTQYF	VVMSWAPPV
CASSFGGGGQPQHF	ELAGIGILTV
CASGTELMNTEAFF	LLLNMLIVL
CASSLASGNEQFF	KLPLDINPV
CASSLWRGMGAGELFF	VVLSWAPPV
CASSQGPGLLSYEQYF	GILGFVFTL
CASSLVTGGGEAFF	FLDEFMEGV
CASTPGQALNEQYF	LLWNGPMAV
CAASARSMDSNYQLIW	GILGFVFTL
CATSRPTVGSRLRDGYTF	NLVPMVATV
CASSALAGGYNEQFF	GILGFVFTL
CASSLLGQSTNEKLFF	VLNYFKPYL
CASSLVMDNYGYTF	YMDGTMSQV
CASSQVGEAGNTIYF	GILGFVFTL
CSARHDLGQGYEQYF	NLVPMVATV
CAGWDRTPYEQYF	FMLLTQARI
CASSYGNTGELFF	MLGEQLFPL
CASETEGVRGGYTF	NLVPMVATV
CASSPGQGGDEQYF	NLVPMVATV
CSAPKEEPYGYTF	SLAPLSPRV
CASSPMGQSYEQYF	ILTGLNYEA
CASSEVNRGINGYTF	GILGFVFTL
CSAIPSYLSIGEQF	YVLDHLIVV
CAWGYQITGSAYGYTF	LLWNGPMAV
CASALGSGGAYEQFF	LLAMTVPNV
CASSQESGGGTEAFF	FLFMYLVTV
CASSYSWGEQFF	VVMSWAPPV
CASRTRQEAFF	GILGFVFTL
CASSYGSNYGYTF	LLWNGPMAV
CASSTVDPMLSEAFF	GILGFVFTL
CASSSDGGLWDTEAFF	NLVPMVATV
CASSSAYYGYTF	NLVPMVATV
CASRGGDGETQYF	KLMNIQQQL
CSASTSGYEQYF	ELAGIGILTV
CASSGLEGAGDTQYF	GILGFVFTL
CAGGIGSYGYPF	GILGFVFTL
CASSPGVSVEQYF	GILGFVFTL
CASSLVGTGELFF	GILGFVFTL
CASSPRRAGAANTGELFF	GILGFVFTL
CASSLGPSLYEQYF	SLAPLSPRV
CASGLTSGLAGGRGNEQFF	NLVPMVATV
CASSPPGTYNEQFF	LMFWASSSI
CASSQDGVQHF	ALYGFVPVL
CSVGGGGAGVETQYF	LLWNGPMAV
CASSLTGTLVDEQYF	GILGFVFTL
CASSIQSTDTQYF	GILGFVFTL
CASSFWAGGWTEAFF	MLNIPSINV
CASLLLGTAAEAF	NLVPMVATV
CSARGALADFNSYEQYF	GILGFVFTL
CAWSGQGYEQFF	GILGFVFTL
CASTESSYNEQFF	ILNVDIFTL
CASSLMDTDTQYF	NLVPMVATV
CASSQVRDRDINYGYTF	KMVAVFYTT
CASSSPDSNNEQFF	RMAAISNTV
CASSLDGRPHLEQYF	GILGFVFTL
CAISESPSGALGQFF	LLWNGPMAV
CASTGTGLNEQFF	GILGFVFTL
CASSPKLQGAWAEKLF	NLVPMVATV
CASSLSGGPQHF	LMFWASSSI
CASSSPSGYEQYF	ALSYTPAEV
CASSLTGAEEQFF	GILGFVFTL
CASSLAASNQPQHF	GILGFVFTL
CASSLQGSDNEQFF	LMMPFSIVYI
CASSYRGVEQYF	KLVALGINAV
CASSEFRDRNQPQHF	KMVAVFYTT
CASSSRSGVEQYF	GILGFVFTL
CASSRGGTGLAGELFF	FMLYLLTLM
CASSQVVVGYGYTF	KLWASPLHV
CASSDQGALSSYEQYF	FIFSYVVAV
CASSLGQSANYGYTF	GILGFVFTL
CASSAYDTDTQYF	GILGFVFTL
CASRPGQGYEQYF	LLWNGPMAV
CASSPLRGPADRTGTEAFF	YVLDHLIVV
CASSLTGAFFNQDQHF	NLVPMVATV
CASSSTGGALDTQYF	GILGFVFTL
CASSSANYGYTF	NLVPMVATV
CATSERGDLNFGTDTQYF	GILGFVFTL
CASSLYRGGDTQYF	KLFEFLVYGV
CASSSGPAYEQYF	LLWNGPMAV
CASSFQGYTEAF	NLVPMVATV
CASSLVSGSPTGELF	NLVPMVATV
CASREGLEDTEAFF	LIIPFIHLI
CASSYGVGTEAFF	GILGFVFTL
CASSQDWGAGTQYF	GILGFVFTL
CASSFTGTSGSPYEQYF	GILGFVFTL
CASSSRSAIEQFF	GILGFVFTL
CARGGGGSYERYF	GILGFVFTL
CASSSVNEQYF	NLVPMVATV
CASSSPLIAGATDTQYF	GILGFVFTL
CASSQDPHGFVANVLTF	GILGFVFTL
CASSFQGLGTEAF	ELAGIGILTV
CASSPWTGAEKLFF	FLTVFSPFM
CASSSTGASNSPLHF	GILGFVFTL
CASSLSPTSGLSYEQYF	NLVPMVATV
CASSYPSTGSSYEQYF	KMVAVFYNT
CASSGRSNTEAF	GILGFVFTL
CASSSRPGELFF	GILGFVFTL
CASSLELAGGPAFF	ELAGIGILTV
CASSLAVTDGAEAFF	GILGFVFTL
CASSRQTEAFF	GILGFVFTL
CASSIFASGNTQYF	GILGFVFTL
CASSFRSPNERNF	GILGFVFTL
CSARHPGVSTDTQYF	ELAGIGILTV
CASSPPGVREQFF	GILGFVFTL
CASSEGMGQPQHF	ELAGIGILTV
CSAEGGGSYEQYF	GILGFVFTL
CASSQESLAGRGAYNEQFF	GILGFVFTL
CSARGMRPEQYF	FMLYLLTLM
CASSDRATQPQHF	GILGFVFTL
CASSNLRWKGRGYTF	NLVPMVATV
CASSLNRGLNTGELFF	KMVAVFYTT
CSANDRSYNEQF	YVLDHLIVV
CASSIFTRRGYEQYF	ILNVDIFTL
CASSEHRDHEQFF	KMVAVFYNT
CASSTGNYGYTF	KLVALGINAV
CASSLQGGGGYTF	FLFTFFASI
CASSLWDTGEQYF	NLVPMVATV
CSVGTSEAYEQYF	NLVPMVATV
CASSYSWTGSNYGYTF	NLVPMVATV
CASSYPTGGDQPQHF	GILGFVFTL
CASSLRGTGSYEQYF	FLFTFFASI
CATSDQGGTEDEQF	ELAGIGILTV
CASRMGSTAFF	LLSIIFFPA
CSAREKGLNYNEQFF	GILGFVFTL
CASSTGGNTEAFF	ILTGLNYEV
CASSYSWGFQETQYF	NLVPMVATV
CASSYSTGGTDTQYF	LLSIIFFPA
CASSPNSAGGTEAFF	LLWNGPMAV
CASSAPGQGNEKLFF	KMVAVFYTT
CARTSGQGVFMNTEAFF	ILNAMIAKI
CALERANEQFF	GILGFVFTL
CASRSSGAFNEQFF	GILGFVFTL
CASSYEGALSYEQYF	ALSPVIPHI
CASSQRSTGELF	GILGFVFTL
CASSLGTGVTEIF	VVMSWAPPV
CASSLSGDEQYF	LLWNGPMAV
CASSYQTGPYSNQPQHF	MMPFSIVYI
CASSYGGGYEQYF	LLWNGPMAV
CASSLRSTGELF	GILGFVFTL
CASSYRVGPLHF	GILGFVFTL
CASSQAPLASGGYTF	ELAGIGILTV
CASSLRGVVSYEQFF	GILGFVFTL
CAISLHGANTEKLF	NLVPMVATV
CASSQEVFRLAETSGEYEQYF	GILGFVFTL
CASSGPIVETQYF	FQLNQSFEI
CASSAQGAYGYTF	LLWNGPMAV
CASSQSTGQPQHF	GILGFVFTL
CAWSGFSRTEAFF	VVTGVLVYL
CASSPHGAAEQYF	GILGFVFTL
CSVLGQDSYEQYF	NLVPMVATV
CASSLGGNTGELFF	ELAGIGILTV
CASSEPGPWAFF	YLDELIRNT
CASSPVAGGAYNEQF	NLVPMVATV
CASSNQGASAYGYTF	LLWNGPMAV
CASSAWDRSSGANVLTF	NLVPMVATV
CAWSHSGGYEQYF	ILNAMIAKI
CASSYFDEKLFF	NLVPMVATV
CASSPGTAYEQYF	LLWNGPMAV
CASRDSVGGGEGYTF	LLSIIFFPA
CASSHVWAGTGFVYGYTF	GILGFVFTL
CASSLEGEQYF	KLVALGINAV
CASSSKRGPYNEQFF	GILGFVFTL
CASSVAAGGAYEQYF	NLNCCSVPV
CASSQEVGLAGETQYF	ELAGIGILTV
CASSQGRGPGKYF	GILGFVFTL
CASSGRAAGELFF	GILGFVFTL
CASSSAASNQPQHF	GILGFVFTL
CAGLGDSGGSNYKLTF	VLFGLGFAI
CASSLAGDRGRNSPLHF	KMVAVFYTT
CASSLAYRPYEQYF	FLPDLNVNA
CASREGSYPKNIQYF	GILGFVFTL
CAWSVGGGGYGYTF	GILGFVFTL
CASSLTGTTYGGYTF	NLVPMVATV
CASSQWGGNEQFF	LLAMTVPNV
CASSYPRDAGTSLDIQYF	GILGFVFTL
CASSLSTVFTDTQYF	ELAGIGILTV
CAITHPPIGETQYF	GILGFVFTL
CASRATGGLGPEAFF	GILGFVFTL
CASSPQTGAVTEAFF	LLWNGPMAV
CASSIRSLDEQFF	GILGFVFTL
CASSLEFGADTQYF	LMFWASSSI
CSSPGREGPQYF	FLIYLDVSV
CASSMGTGGFYGYTF	HQLGGVVEV
CASSLGAGGGGTQYF	ELAGIGILTV
CASSDAENTEAFF	NLVPMVATV
CASGEGGELFF	NLVPMVATV
CASSFRGSYTF	GILGFVFTL
CAWSVPGTYSYEQYF	GILGFVFTL
CASSQDDLEGSEAFF	GILGFVFTL
CASSLAERSYEQYF	NLVPMVATV
CASSEESGRAAEQYF	NLVPMVATV
CASSFSATGELFF	KLSHQPVLL
CASSFSSSYNEQFF	GILGFVFTL
CASDSNYGYTF	FIDCYLLAI
CASSLADVGQYDTDTQYF	TLSKPSPMPV
CASSPGTGGYTEAFF	LLWNGPMAV
CASSARSAETQYF	GILGFVFTL
CASSPQGLGTEAF	ELAGIGILTV
CASTPPGGRGYTF	GILGFVFTL
CASSLVSAHEQYF	GILGFVFTL
CASSLDRAIGVTYEQYF	GILGFVFTL
CASGVRSAYEQYF	GILGFVFTL
CSATSEYTEAFF	KLVALGINAV
CASSTQGSQPQHF	GILGFVFTL
CASRSRGGHSPLHF	GMGPLLATV
CASSESGTANEQFF	NLVPMVATV
CASSLNTEAFF	YLQDSMATT
CAWSVSGNTEAFF	KLMNIQQKL
CASSEAPGTSVGGLFF	ELAGIGILTV
CAWIGLGGETQYF	GILGFVFTL
CASSLIKVQPQHF	GILGFVFTL
CASSPRAGTGNSPLHF	NLVPMVATV
CASSQVEGYEQYF	NLNCCSVPV
CASSSRSANEQFF	GILGFVFTL
CASRGLLGGITEAF	YVLDHLIVV
CSARDRAGEGYNEQFF	GILGFVFTL
CASSETGFGNQPQHF	NLVPMVATV
CASTATFGVTEAFF	LIIPFIHLI
CASSMGSYGYTF	GILGFVFTL
CASSLGQGGVGEKLFF	WLSLLVPFV
CSVEDEGLTDTQYF	GILGFVFTL
CSVEHASGTYEQHF	GILGFVFTL
CSAIPGTGGRIKAFF	GILGFVFTL
CASSPSGHYEQYF	ELAGIGILTV
CASSIRSSDTQYF	GILGFVFTL
CASSFGQGQPQHF	ELAGIGILTV
CASSLMGQGINQPQHF	GILGFVFTL
CASSYSGGGNQPQHF	LLWNGPMAV
CASSPTGGGTGELF	NLVPMVATV
CASSLDRDRGRPEAF	NLVPMVATV
CAWSSRGQMTDTQYF	NLVPMVATV
CATSDLPYIGTRLNEQFF	VLFGLGFAI
CASSEWGIEAFF	NLNCCSVPV
CASSFGANTGELFF	FLTYLDVSV
CASSPPGENYNEQFF	GILGFVFTL
CASSYSTGTPGIYTF	NLVPMVATV
CASSPDLNPYEQYF	VVMSWAPPV
CATSRDRGLTEAFF	KLVALGINAV
CSASLLASTSGGAGNEQFF	GILGFVFTL
CASSWDKTYEQYF	GILGFVFTL
CARGSGGETQYF	LLFALYFSA
CASSAGQGYEQYF	LLWNGPMAV
CASSYSQGVYTGELFF	ELAGIGILTV
CASSWGLTYEQYF	GILGFVFTL
CASREDGTEAFF	NLVPMVATV
CASRAGRAYEQYF	GILGFVFTL
CASSQDRDSGYYEQYF	NLNCCSVPV
CASSPHTEAFF	FIDCYLLAI
CSAPLAGGHNEQFF	LLWNGPMAV
CASRKTVTAYNSPLHF	NLVPMVATV
CATSVGSGPLSTDTQYF	SLPITVYYA
CASSSRSAYEQYF	GILGFVFTL
CASSYSMEAGGETQYF	GILGFVFTL
CASRGDYGYTF	GILGFVFTL
CASSPAVGTGDEKLFF	FMLYLLTLM
CASSSGTGAYEQYF	HIAKSPFEV
CASSLHFEVEKLF	YVLDHLIVV
CASSLGAGIGYTF	GILGFVFTL
CASSPGTISYEQYF	VLNPFIYML
CASTSWAQASTDTQYF	NLVPMVATV
CASSYSGAEQYF	LLFGMPPCL
CASGPGTAYGYTF	LLWNGPMAV
CASSFRLGQGHYGYTF	YVLDHLIVV
CSARSLYSTDTQYF	NLVPMVATV
CSVGGQGARCNQPQHF	GILGFVFTL
CASSKGQGAYGYTF	NLVPMVATV
CASSLGLGTGELFF	GILGFVFTL
CASSSESGELFF	LLLNMLIVL
CASSLSSANYGYTF	NLVPMVATV
CSVADSTYEQYF	NLVPMVATV
CATIPARSGTEAFF	GILGFVFTL
CASSYSPGAYTEAFF	FLYNLLTRV
CASMRGAHTGELFF	ELAGIGILTV
CASSLVGSGGEQYF	NLVPMVATV
CATSRGPTQAPYEETQYF	QLLVSLWGL
CASSIHGAETQYF	GILGFVFTL
CASSLIFPSGEQYF	GILGFVFTL
CASSRGLAANTGELFF	GILGFVFTL
CASTTGDGLGAFF	ELAGIGILTV
CSASNQESYGYTF	YVLDHLIVV
CASSLYPLGFGYTF	LLWNGPMAV
CASSGRSAETQYF	GILGFVFTL
CASSQDGLAPYEQYF	GILGFVFTL
CASSLAGRETEAF	NLVPMVATV
CASSIYSNGEQYF	GILGFVFTL
CASSSRDRSSSTEAFF	IMDQVPFSV
CASSVVNEAFF	NLVPMVATV
CASSDLQENQPQHF	ALIHHNTYL
CATSAKTRLNTEAFF	FLDEFMEGV
CAWSVSDVANTEAFF	NLVPMVATV
CASSVRSTGELFF	GILGFVFTL
CASSIRRAYERYF	GILGFVFTL
CASSYTGWHEQYF	FLFMYLVTV
CASSILTGPRTEAFF	GILGFVFTL
CAGSVLRGGRNERFF	GILGFVFTL
CASSQAGGRDEAFF	GILGFVFTL
CASSGQGHPYNEQFF	ILTGLNYEA
CASSFLAGGNNEQF	NLVPMVATV
CASSVWDSLTGELFF	NLNCCSVPV
CASMGGASYNEQF	YVLDHLIVV
CASSILGASYNEQFT	GILGFVFTL
CSATEGGLWEQYF	GILGFVFTL
CASSIVNEAFF	NLVPMVATV
CASSGVAEWALETQYF	ALYGFVPVL
CAISDGGRTDTYEQYF	NLVPMVATV
CASSLGGGGFYEQYF	NLVPMVATV
CASSTGGDTQYF	KLSREIMPV
CAWMGSYNEQFF	KLMNIQQKL
CASSPGPYEQYF	QLIPCMDVV
CASSLLQGTEAFF	GILGFVFTL
CASSLALAGTDTQYF	GILGFVFTL
CASSLGTGLYGYTF	GILGFVFTL
CASYPISRASYEQYF	ALSPVIPLI
CASSLDLSSGANVLTF	YVLDHLIVV
CSARGDLLPEAFF	VVMSWAPPV
CASSLSSAGGAVYGYTF	NLVPMVATV
CSVEGRGTDTQYF	LLWNGPMAV
CASSPPLGLHTGELF	YVLDHLIVV
CASSVDGGPQETQYF	AVGSHVYSV
CASSVESGEQYF	FLTYLDVSV
CASSIGDTSYEQYF	GILGFVFTL
CATSDLGQGLDNEQF	NLVPMVATV
CASSFGTGHTGELF	NLVPMVATV
CASSQEGTPISYEQYF	LLWNGPMAV
CSATGQNYEQYF	ILTGLNYEV
CAWRPAMVYEQYF	NLVPMVATV
CAWSRTGATEAFF	GILGFVFTL
CSAREQRGYNEQFF	NLVPMVATV
CASSYSVKGQDYSYEQYF	NLNCCSVPV
CASSPGRDYEQYF	GILGFVFTL
CASSLPAAGYGYTF	LLWNGPMAV
CASSTRSAYEQYF	GILGFVFTL
CATGRGGMIGEQYF	NLVPMVATV
CASSEAISGAWDEQFF	GILGFVFTL
CSVDDRGTTEAFF	GILGFVFTL
CASRSGREAFF	GILGFVFTL
CSARTWTGNTIYF	ILNVDIFTL
CASSIAPGNEQYF	LLFGMPPCL
CASSFTSRGTGELFF	NLVPMVATV
CASSQVAKMAKDNYGYTF	LLWNGPMAV
CASSSQGAYGYTF	LLWNGPMAV
CASSTINTNSPLHF	SLDPTTSPV
CASSLVAGPYSQETQYF	MMPFSIVYI
CASSLGGNPTYNEQFF	KLFEFLVHGV
CASSFGGSSYEQYF	VVLSWAPPV
CASSMRSGYEQYF	GILGFVFTL
CASSMRSTGELFF	GILGFVFTL
CASSIRSVAEAF	GILGFVFTL
CASSSPGQGYYEQYF	VLFHRAFLV
CASSLEGANYGYTF	GILGFVFTL
CASSIESGSKQRNEQFF	ALIHHNTHL
CASSSRSGHEQYF	GILGFVFTL
CASGLDTQYF	FLYNLLTRV
CASRKGGSSYNEQFF	NLVPMVATV
CASRATMGGGTEAF	YVLDHLIVV
CASSSQTGQMSF	GILGFVFTL
CASSVGGGHQPQHF	ILTGLNYEV
CASLIVPWGTSGTTDTQYF	NLVPMVATV
CASSSRSSYEQYF	GILGFVFTL
CASSLAGGSNQPQHF	GILGFVFTL
CASSYSRTANEKLFF	NLVPMVATV
CASSTGADLTYEQYF	LVIGMPPPV
CSVVDSGKTHNEQFF	GILGFVFTL
CASSPVGYEQYF	ALYGFVPVL
CASSWGSEVVADTQYF	GILGFVFTL
CASSLGGSNYEQYF	ELAGIGILTV
CASSIGGDEKLFF	GILGFVFTL
CASSPGLGTYEQYF	LLWNGPMAV
CASGRSGEDYGYTF	LLSIISFPA
CSARDPSGLAGGLAETQYF	NLVPMVATV
CASSLGDWDLEAFF	SLPITVYYA
CASSGRPTETQYF	GILGFVFTL
CATSLRTSGIIEQYF	GILGFVFTL
CASRGLIIQRSSYEQYF	VLFGLGFAI
CASSLYGGESQETQYF	VVLSWAPPV
CASTQWYGGGTPPYF	ELAGIGILTV
CASSIGAYGYTF	GILGFVFTL
CASTSWGETQYF	GILGFVFTL
CASSIYRLGYEQYF	GILGFVFTL
CSVGTYSNQPQHF	ALYGFVPVL
CASSWAGGPRDEQYF	NLVPMVATV
CASSITSLGELF	GILGFVFTL
CASRRDSSGYTF	KLVALGINAV
CASSFRQTLAVYEQYF	LLSIIFFPA
CASASANYGYTF	NLVPMVATV
CSSLGTSFRTDTQYF	YVLDHLIVV
CASSFSGGAPGELF	NLVPMVATV
CASSQGRDRPTEAFF	NLVPMVATV
CASSYGQNYEQYF	GILGFVFTL
CASSGSSVETQYF	LIIPFIHLI
CASSQEAGGEQYF	NLVPMVATV
CATSRDRYEQYF	GILGFVFTL
CASSLVPSGQANTEAFF	KMVAVFYTT
CASSLEGAGGADTQYF	GILGFVFTL
CASSQRSLSGANVLTF	GILGFVFTL
CASSYGGAYEQYF	NLNCCSVPV
CASSYQTGNEQFF	ALYGFVPVL
CASSSEFGDTAYNEQF	NLVPMVATV
CSARGQQGAHEQYF	GILGFVFTL
CSARDTSNQPQHF	GILGFVFTL
CASSGRSGETQYF	GILGFVFTL
CAWMGAGQRNTIYF	GILGFVFTL
CASSVGGGEVEAFF	KLWASPLHV
CASSLSIIDPRYF	LLAILPYYV
CASSSQSNQPQHF	GILGFVFTL
CASSHEVYYEQYF	NLVPMVATV
CASSATGTGGYEQYF	LLWNGPMAV
CASSGRSTDTQYF	GILGFVFTL
CSARDPQGFDGYTF	LLAIKVPNV
CASSQWVITANEKLFF	GILGFVFTL
CASSPPDGQGDYGYTF	KMVAVFYNT
CASSQGSGANVLTF	ALYGSVPVL
CIVRRGGTSYGKLTF	GILGFVFTL
CASSTRSAAPLHF	GILGFVFTL
CASSVDRVADTQYF	GMGPLLATV
CASSLAWALQDEQYF	ELAGIGILTV
CSVEEWDTSGNTIYF	RLVPYLEFL
CASSSTQGAAYGYTF	LLWNGPMAV
CASSGGTADTQYF	LLWNGPMAV
CSVEDGRDTGEGTDTQYF	GILGFVFTL
CASSIGGTGGLPQHF	NLVPMVATV
CASSPITGTSLANEQFF	GILGFVFTL
CASSMERTGSDTGELF	GILGFVFTL
CASSLTLVFEAFF	GILGFVFTL
CASSLGQTVTQETQYF	FLYNLLTRV
CASSPNLAGEEQYF	ELAGIGILTV
CSAFSGAAFVTDTQYF	NLVPMVATV
CASSLGSTGTYEQYF	LLWNGPMAV
CASSQDRLAGGLETQYF	GILGFVFTL
CAQGDYNEQFF	LLAMKVPNV
CSAVDSNSNQPQHF	GILGFVFTL
CASSSGSFYEQYF	GILGFVFTL
CASSPTAEAFF	TLFTMVGTV
CASSQGAFGYTF	GILGFVFTL
CASSVGAGVFTDTQYF	NLVPMVATV
CASSPYGNTIYF	SLLWMNLFV
CASSISPSSYEQYF	KLWASPLHV
CASSSRIGTYGYTF	GILGFVFTL
CASSFEWSYEQYF	GLLHHAPSL
CASSQALPDEQYF	NLVPMVATV
CASGLSDRGGDEQF	NLVPMVATV
CASSLTGTASTYGYTF	GILGFVFTL
CASSEWDSEPQHF	GILGFVFTL
CASSLVGTGGWDEQF	NLVPMVATV
CASSELGGAGTGELF	NLVPMVATV
CASSIRSTGELF	GILGFVFTL
CSARPTSNYEQF	YVLDHLIVV
CASSASEPSGETQYF	RLGPYLEFL
CSVDNKAGGGYTF	YVLDHLIVV
CSARNRDTYYNEQFF	ALLETLSLLL
CASSFDRGGNYGYTF	GILGFVFTL
CASSQGLNPGQGLDTEAFF	LMMPFSIVYI
CASSQEVAYEQYF	LLWNGPMAV
CASSIYSNQPQHF	GILGFVFTL
CASSQGEGTEAFF	GILGFVFTL
CASSPSPSGDDEKLFF	NLVPMVATV
CASSLLGGWSEAFF	GILGFVFTL
CASSWGQGDGYTF	ELAGIGILTV
CSARSGGTEAFF	FLTVFSHFM
CASSLLSGTSLRVTGELFF	GILGFVFTL
CASSIRSSGPQFF	GILGFVFTL
CSAPSYRELAGAYLQETQYF	FLNVLFPLL
CASSWETETEAFF	GILGFVFTL
CASSSGTVSYEQYF	LLWNGPMAV
CASSLDGATYNEQFF	GILGFVFTL
CASTPPGSETQYF	ELAGIGILTV
CASSHRDSGNTIYF	NLVPMVATV
CASGFGNTEAFF	NLVPMVATV
CSVEGTRGYNEQFF	GILGFVFTL
CASSLGQEIPYYGYTF	ALSYTPAEV
CASSQDRGTGYNEQFF	GILGFVFTL
CASRSPQETQYF	GILGFVFTL
CASSEANEKLFF	ELAGIGILTV
CAWSQGASGNQPQHF	GILGFVFTL
CASSPNRGPSDTQYF	GILGFVFTL
CSARDKFYRASGDSYEQYF	GILGFVFTL
CASSISTEAFF	YLQDSMATT
CASSSRTGDTQYF	LLWNGPMAV
CASSTGSYGYTF	GILGFVFTL
CASSLIDTGELFF	RMAAISNTV
CAWSSSVNTEAFF	ILGGQVVHTV
CASSFPNQPQHF	LLWNGPMAV
CASSYNSMNTEAFF	KLMNIQQQL
CASIWAGLGQPQHF	ELAGIGILTV
CASSQEGSGGTEAF	NLVPMVATV
CASSIRSFYEQYF	GILGFVFTL
CASSPLGGAGEDTQYF	NLVPMVATV
CASRPQGLGNTIYF	ELAGIGILTV
CASSMRSSWEQYF	GILGFVFTL
CASSLSPTDTQYF	KMVAVFYTT
CASSQALPYEQYV	NLVPMVATV
CASSLGQERPYEQYF	KMVAVFYTT
CASSQVPGSYEQYF	KLNTITPVV
CASSIRSGEPQHF	GILGFVFTL
CASSGRATDTQYF	GILGFVFTL
CASSVRSADTQYF	GILGFVFTL
CASSMRAGVEQFF	GILGFVFTL
CASSQGPPGSGGGNEQFF	ALSPVIPLI
CASSLVWSSGGQETQYF	NLVPMVATV
CASSLTGGGHNSPLHF	GILGFVFTL
CASSLRSAYEQYF	GILGFVFTL
CATTIYEQYF	GILGFVFTL
CASGDSGALEFF	KLMNIQQQL
CASSSPTSGADNEQFF	KMVAVFYTT
CASSFTPYNEQF	ELAGIGILTV
CSVEGLYEQYF	NLVPMVATV
CSVDETGGGETQYF	NLVPMVATV
CASTPSWAGGPTDTQYF	GILGFVFTL
CATSDSTGSYGYTF	LLGATCMFV
CATSRASGSYEQYF	LLWNGPMAV
CASSFGQNYEQYF	KLWASPLHV
CASRGPYNEQFF	VVMSWAPPV
CASSPGHAYEQYF	LLWNGPMAV
CASSDPRGEETQYF	GILGFVFTL
CASSPPLWGVYGYTF	KMVAVFYTT
CASSLGENIQYF	NLVPMVATV
CASSTRAAYEQYF	GILGFVFTL
CASSQDIGNFEQFF	RLLPLLALL
CASSRHPGGDDYNEQFF	GILGFVFTL
CASSVGLGLYEQYF	GILGFVFTL
CATSRDLVAETQYF	NLVPMVATV
CASSLTGVDGYTF	FLYNLLTRV
CASRGGGSPLHF	GILGFVFTL
CASSLSGVAYGYTF	ILTGLNYEA
CASSIGGGQNTEAFF	GILGFVFTL
CASSLESTANTEAFF	FLYNLLTRV
CASSTALAASYEQYF	IMDQVPFSV
CSVSTGGFGNQPQHF	GILGFVFTL
CASSSHHGSPLGQYF	GILGFVFTL
CSARNGEGFSYEQYF	GILGFVFTL
CASSDWTGSLGNNEQFF	GILGFVFTL
CASSFTSGSGHEQYF	VVLSWAPPV
CAGGRKRNTQYF	GILGFVFTL
CASSLGRSSYEQYF	FMLYLLTLM
CASSDSGTTNEKLFF	GILGFVFTL
CSARDGTRAHYEQFF	GILGFVFTL
CASSMRSTDTQYF	GILGFVFTL
CASPRQSPLHF	GILGFVFTL
CASSARVGNEQYF	GILGFVFTL
CSAAGDRGADTQYF	LLWNGPMAV
CASSIGSYGYTF	GILGFVFTL
CASSPSSGAYEQYF	NLVPMVATV
CSARAGLRESTDTQYF	GLMAIAWFI
CASSGGRNQPQHF	GILGFVFTL
CASSIRSSYERYF	GILGFVFTL
CASSPLFGREPDGETQYF	NLVPMVATV
CAIRDKMNTEAFF	NLVPMVATV
CASSFWRDGATNEKLFF	KMVAVFYTT
CASSQERWAEAFF	NLVPMVATV
CASSFGPYGYTF	VVLSWAPPV
CASSLNRGPSDTQYF	GILGFVFTL
CAWSGQGYEQYF	GILGFVFTL
CASSTGGTSGGRNTGELFF	ILTGLNYEA
CASSIRSGHEQFF	GILGFVFTL
CASSLVGGGMGWEQFF	NLVPMVATV
CASSSHRGEGAFF	GILGFVFTL
CASSPGTGPRTLHF	GILGFVFTL
CSARDGTSSGYF	ELAGIGILTV
CASSLARDGYTF	GILGFVFTL
CASSFGSGEQFF	MLGEQLFPL
CASSFSSLNTGELFF	NLVPMVATV
CATSSGSRQGNNEQFF	GILGFVFTL
CASSYHSSYEQYF	FMLYLLTLM
CASSSGGAWYTF	ILNAMIAKI
CASRYQGLGQPQHF	ELAGIGILTV
CASSDAGLGNTIYF	ELAGIGILTV
CASSQEQLGGEQYF	LMFWASSSI
CASSVGGVTYNEQFF	LLWNGPMAV
CSGRINTEAFF	GILGFVFTL
CILRDPFTGGGIKFTF	GILGFVFTL
CATAPREDRVGNEAF	ELAGIGILTV
CATGAASSYEQYF	LLWNGPMAV
CASSSLGEQFF	ALYGFVPVL
CASSLSLLAGNNEQF	NLVPMVATV
CASSPGQGLAYEQYF	NLNCCSVPV
CASSVAGLAGGNPNEQFF	GILGFVFTL
CASSTLSGNYNEQFF	VLMGGVPGVE
CASSLEGTGLTDTQYF	ELAGIGILTV
CASSAGPWGYTF	ILLDWAANV
CASSFGLNQPQHF	NLVPMVATV
CAGSVTGALGTEAFF	GILGFVFTL
CASSLLASGFGTDTQYF	GILGFVFTL
CSARRTGSTYNEQFF	NLVPMVATV
CASSVGDFNYGYTF	NLFNRYPAL
CASSDRSGNEQFF	GILGFVFTL
CASSSGYNEQFF	VLLGVKLFGV
CSARDIMNTGELFF	NLVPMVATV
CASGAQHTEAFF	KLVALGINAV
CASSYATGIPDTQYF	NLVPMVATV
CASSFSLGAAGELF	YVLDHLIVV
CATSRATSNQPQHF	LLWNGPMAV
CASSFRGEAFF	AVGSHVYSV
CSARDPSQGGYEQYF	MLNIPSINV
CASSFLQVTEAF	NLVPMVATV
CASSSNIGGSPLHF	NLVPMVATV
CASSPRDGQETQYF	GILGFVFTL
CASSQDITVLYGYTF	GILGFVFTL
CASSSPLIAGATTDTQYF	GILGFVFTL
CASSPGGGELFF	KMVAVFYNT
CASSPGGGYEQYF	NLNCCSVPV
CASSLGDRGPQPQHF	AVGSYVYSV
CAWSVGGGGYTF	GILGFVFTL
CASSVATEGYEQYF	LLWNGPMAV
CASSPVQGAFYNSPLHF	NLVPMVATV
CASSVSRAGTGELFF	NLVPMVATV
CAISDWSTYEQYF	GILGFVFTL
CASSVAGGYEQYF	KLWASPLHV
CASSIRPSYERYF	GILGFVFTL
CASSLARGGLGEQYF	NLVPMVATV
CASSANQGYEQYF	NLNCCSVPV
CASSEGGTGGFNSHEQYF	GILGFVFTL
CASSYGTGGNEQF	ELAGIGILTV
CASSISSTGELF	GILGFVFTL
CASTRELSYNEQFF	LMFWASSSI
CASGRGPNYGYTF	LLWNGPMAV
CAISEWDIHSSGNTIYF	NLVPMVATV
CASSLGQGRRDEQFF	GILGFVFTL
CASSDRTSGINEQFF	GILGFVFTL
CASSEALYEQYF	LLWNGPMAV
CASSYQTGTGVYGYTF	NLVPMVATV
CASSEAVLGGNSYEQYF	LLWNGPMAV
CAWSNQPQHF	NLVPMVATV
CASSPRTGFSSGNTIYF	GLTSFFIAI
CASSYSTGTAYGYTF	NLVPMVATV
CASRFQGFTEAF	NLVPMVATV
CASSEGSEAFF	LMFWASSSI
CASRPRQVETQYF	MIISHLYLI
CASSLAQTTPLNEQF	NLVPMVATV
CASSQEVGSSYNSPLHF	SLAPLSPRV
CASSQDWAASNSPLHF	LLFAAFSSA
CASSQEPSLNTEAFF	FIYQYYSSI
CASSQDWSYEQYF	ELAGIGILTV
CASSQALLAPSTDTQYF	ELAGIGILTV
CASSQDTDGRMFF	ELAGIGILTV
CASSFGRNRSQNTEAFF	MLYQHLLPL
CSAIGPRGTDTQYF	LLWNGPMAV
CATSRGTVSYEQYF	NLVPMVATV
CASSPGQGIDSPLHF	NLNCCSVPV
CASSFALSNEAFF	ELAGIGILTV
CASSLWAEPDTQYF	ALYGFVPVL
CASSQPKGPNEKLFF	GILGFVFTL
CASSDAGGGMAEAFF	GILGFVFTL
CASSLAYEQYF	AVGSHVYSV
CSGAPPYNEQFF	NLVPMVATV
CASSLDRDYGYTF	GILGFVFTL
CASSPGLAASYNEQF	NLVPMVATV
CSAWWGAEQYF	LLWNGPMAV
CASSLGVGTEAFF	GILGFVFTL
CAWSPGQGGQETQYF	GILGFVFTL
CASSGGYEQYF	LLWNGPMAV
CASSSPTSGDYEQYF	GILGFVFTL
CSARLKGGGDTQYF	ILTGLNYEA
CTSSQDLRRKISTDTQYF	ALYGFVPVL
CASSLASEQYF	KLSREIMPV
CASGLVPGGLVYEQYF	GILGFVFTL
CASSDRANTEAFF	GILGFVFTL
CASSFTGRSPLHF	NLVPMVATV
CASSWSQLVHEQF	ELAGIGILTV
CASSHGTAGSGNTIYF	GILGFVFTL
CATSRDRGTDTFF	KLVALGINAV
CASSMAGEQYF	ELAGIGILTV
CASSSDRAGSPLHF	MLYQHLLPL
CASSAGSYGYTF	GILGFVFTL
CASSQGPGLLSYGQYF	GILGFVFTL
CSVEGLRGGNEQFF	KLMNIQQQL
CAWSGRLAGESGELFF	NLVPMVATV
CSAPQLAGGTDTQYF	GILGFVFTL
CASSMGSHGYTF	GILGFVFTL
CASSIGYFGYTF	GILGFVFTL
CASSERGHYGYTF	LMFWASSSI
CASSYGTGNIQYF	ELAGIGILTV
CASSFGQGAETQYF	GILGFVFTL
CASSLQGSYEQYF	VVMSWAPPV
CASSPTGNEQFF	FLIYLDVSV
CAWSAGEQYF	VVLSWAPPV
CASSQAQGTYEQYF	LLWNGPMAV
CASSLGGQDANQPQHF	NLVPMVATV
CASSTRDSNTGELFF	NLVPMVATV
CASSQEVMTALQPDYGYTF	GILGFVFTL
CASSYELRTGVFDTQYF	NLVPMVATV
CASSIGTVNRGPNTEAFF	FLNDLLSVL
CSVGKSTSVPLNEQFF	GILGFVFTL
CASSPATGPREQYF	GILGFVFTL
CASSQVSGGSYEQYF	NLNCCSVPV
CASSIVHAADTQYF	GILGFVFTL
CAGSLGGGSYEQYF	NLVPMVATV
CSARGAGVPYEQYF	MLNIPSINV
CASSDPTGRLGTEAFF	GILGFVFTL
CASGTLNSNQPQHF	ILTGLNYEA
CSARWDRVSSSTDTQYF	VLFHRAFLV
CASSVGTSSYGYTF	FLYNPLTRV
CASSILAVAGNEQFF	GILGFVFTL
CASSLRTGTNSYEQYF	GILGFVFTL
CAASGGSNYKLTF	GILGFVFTL
CASSFGTFGAYGYTF	NLVPMVATV
CASSALGAGGDTQYF	GILGFVFTL
CASSPGQGLPNHF	ELAGIGILTV
CSAREPDDTREAF	NLVPMVATV
CSVEDYSTGIISGNTIYF	NLVPMVATV
CASSLNPGTSYEQYF	KLPLDINPV
CAWSVSDLAKNIQYF	NLVPMVATV
CATSSASSYEQYF	LLWNGPMAV
CASSLGPGGASYTF	KLANPLPYT
CASSLTYGEYEQYF	NLVPMVATV
CASSRQGGYGYTF	LLWNGPMAV
CASSVGSEAYTYEQYF	NLVPMVATV
CASSPSRQSLNTEAFF	GILGFVFTL
CASSMGQGTYEQYF	GILGFVFTL
CASSTNRGTLGEQYF	LLAGTLAGV
CASSQGALGYTF	KLFEFLVHGV
CASSPGLAGNNEQYF	GILGFVFTL
CASTGQNPEAFF	GILGFVFTL
CASSFGVGANVLTF	ELAGIGILTV
CASSQTLAGGGETQYF	YVLDHLIVV
CASSPALTGGLIEQYF	ELAGIGILTV
CASSLAEVHNEQFF	GILGFVFTL
CASSSPLIAGTIDTQYF	GILGFVFTL
CASSFTLGTGGVEQYF	NLVPMVATV
CASRQALPYEQYF	NLVPMVATV
CASRARSPNEQNF	GILGFVFTL
CASSLPGLASHEQFF	ELAGIGILTV
CASSWQGNQPQHF	GILGFVFTL
CAWSVSVYYGYTF	ILNVDVFTL
CASSMRSGNTIYF	GILGFVFTL
CSASDNMVGAYEQYF	LLWNGPMAV
CASMVGQGTGELFF	GILGFVFTL
CAYSGTAPHEQYF	GILGFVFTL
CASSPTGGNTEAFF	GILGFVFTL
CASSLRGRVRETQYF	NLVPMVATV
CASSKSASYEQYF	GILGFVFTL
CASSTYSTDTQYF	GILGFVFTL
CASSQEPNNNEQF	NLVPMVATV
CASSNVLAGGRDTQYF	ALYGFVPVL
CATAKEGLAYEQFF	KLVALGINAV
CASRPTTGLKLFF	GILGFVFTL
CASSEVQGGRDTQYF	VVLSWAPPV
CASSGRASGELFF	GILGFVFTL
CSALTGNQPQHF	ELAGIGILTV
CASSLLIQGGENTEAF	NLVPMVATV
CASSMTSYNEQYF	ELAGIGILTV
CASSYTGTGSQPQHF	LLWNGPMAV
CASRSGAEAFF	GILGFVFTL
CASSLERNTYEQYF	GILGFVFTL
CASNREVSTDTQYF	VMPFSIVYIV
CASGTLLIRGKGYERYF	VLFGLGFAI
CASSIVASGAGGELFF	GILGFVFTL
CASSYTIGNEQYF	ALSPVIPHI
CASSEGQGPSYEQYF	GILGFVFTL
CANNCGFF	LLWNGPMAV
WASSQQTGTIGGYTF	NLVPMVATV
CASSFNTEAFF	YLLFMIGYT
CASATGADTEAFF	GILGFVFTL
CASSERDRTTNEKLFF	GILGFVFTL
CASSLTGATDTQYF	LLAILPYYV
CSVVTENNYGYTF	GILGFVFTL
CSVRSGGAKNIQYF	GILGFVFTL
CASRGGGGFYEQYF	VLNYFKPYL
CASSLLQGPSYEQFF	GILGFVFTL
CAVGPSNTGKLIF	GILGFVFTL
CASSQGEGYEQYF	KLWASPLHV
CASSVRSSYEQYF	NLVPMVATV
CASSLRSSYEQYF	GILGFVFTL
CASSPYRTGNIQYF	ELAGIGILTV
CSVELTTYEQYF	MIISHLYLI
CASRLGQGRRDEQFF	GILGFVFTL
CASSLGQGWETQYF	ILNVDVFTL
CSVELASGTYEQYF	GILGFVFTL
CASSQGGSGEDTEAFF	GILGFVFTL
CASSQDALGYEQYF	NLVPMVATV
CASSLSVSTSLDTQYF	YVLDHLIVV
CASSPGTGHGELF	NLVPMVATV
CSAPTSGGHNEQFF	LLWNGPMAV
CASSPGVLANEQYF	ELAGIGILTV
CASSVRAAWEQYF	GILGFVFTL
CASSITLGTGGVEQYF	NLVPMVATV
CASSLYSNQPQHF	GILGFVFTL
CASSQDRWDVMSKNIQYF	VLFGLGFAI
CSVLGTQEESYEQYF	GILGFVFTL
CASSLSGQGATNEKLFF	MLYQHLLPL
CASSIRSSTEAFF	GILGFVFTL
CASSIRSTETQYF	GILGFVFTL
CASSSRSGEKLF	GILGFVFTL
CASSLVEAGDPYEQYF	NLVPMVATV
CATSGSYEQYF	ELAGIGILTV
CATSGYLLDRSTDTQYF	GILGFVFTL
CASSGTDSNQPQHF	NLVPMVATV
CASRDAVNSYEQYF	VLNPFIYML
CASRPLLETYDQPL	GILGFVFTL
CASSYLEGSETQETQYF	GILGFVFTL
CASSLAVGQPGEEEQYF	KMVAVFYTT
CASSDRSSYEQYF	GILGFVFTL
CASHYGGSSYEQYF	NLVPMVATV
CASSLAKMDLPLAKNIQYF	NLFNRYPAL
CASSGFRGELFF	ILTGLNYEV
CASSQVSGDEAFF	GILGFVFTL
CSARDDFGQGSYNEQFF	GILGFVFTL
CASSLERGMGSNQPQHF	KMVAVFYTT
CATEQGMHEQYF	NLVPMVATV
CASSPGTVAYEQYF	LLWNGPMAV
CASSPMTGAEQFF	VVMSWAPPV
CASSLSLPAGGRETQYF	NLVPMVATV
CASSIFSGANVLTF	GILGFVFTL
CASSLRQGEGMGEQF	NLVPMVATV
CASSQNGSEAAYSNQPQHF	VQYLGMLPV
CSAKRPSSYNEQFF	NLVPMVATV
CASLAPGTTNEKLF	NLVPMVATV
CASSSRDKPQETQYF	NLVPMVATV
CASSLGGQAAGYGYTF	GILGFVFTL
CASSLAPGDGYEQYF	NLVPMVATV
CASSFYSNQPQHF	GILGFVFTL
CASSPKAGAAEAFF	GILGFVFTL
CASTGTARFTGELFF	NLVPMVATV
CASSYGVNTEAFF	FMLYLLTLM
CASSSINRDKMNTEAFF	KMVAVFYTT
CASSPGSINYGYTF	NLVPMVATV
CATSDSSGPYNEQFF	GILGFVFTL
CASSISGGSYEQYF	RLGPYLEFL
CAWSVGGGYGYTF	GILGFVFTL
CASSNRASNEQFF	GILGFVFTL
CASSLAGSSDEQFF	GILGFVFTL
CASSQEWGINEKLFF	GILGFVFTL
CASSLGLADPNNEQFF	LLFGYPVYV
CASSSRQGAANEKLFF	GILGFVFTL
CASSTLDRTSGFDTQYF	GILGFVFTL
CASSLPPADMRDTQYF	LLFGMPPCL
CSAKVEGYEQYF	NLVPMVATV
CASSIRGSYEQYF	GILGFVFTL
CATSGTGYYEQYF	GILGFVFTL
CASSFWGLGELFF	VLMGGVPGVE
CASSYSGLGQPQHF	ELAGIGILTV
CASSIRSADTQYF	GILGFVFTL
CASSLGGLVYNEQFF	MMPFSIVYIV
CSARSGLAGGGDTQYF	GILGFVFTL
CASSTRSTYEQYF	GILGFVFTL
CASSIRSTYEQYF	GILGFVFTL
CASSSTDGYQETQYF	ALLQVTLLL
CASSGAAGTSAYNEQFF	ALSPVIPLI
CASSVGGDIGIGYTF	KLVALGINAV
CASSPTTQGSYEQYF	NLVPMVATV
CASSVGTGYEQYF	FLTYLDVSV
CASSLAPGTTNEKLFF	NLVPMVATV
CASSIRAAYEQYF	GILGFVFTL
CASSLPRDLASGRTKTRSYNEQFF	GILGFVFTL
CASSVASGGYTDTQYF	ILTGLNYEV
CSARDYAAYEQYF	GILGFVFTL
CSVGRLGLPYNEQF	NLVPMVATV
CSARASGAYEQYF	NLNCCSVPV
CASMTNNQPQHF	MLNIPSINV
CASSSDSQETQYF	FMIGYTSAL
CASSLSYEQYF	FLTVFSHFM
CATRGGEGQPQHF	LLFGYPVYV
CASSQGTSGTDTQYF	FLYNLLTRV
CASSFPDRGQGVYGYTF	LIIPCIHLI
CASRTGTGAFYEQYF	GILGFVFTL
CASSYNQGYEQYF	ILNAMIAKI
CASSTSAGFSNQPQHF	VVTGVLVYL
CAWSVAGDTDTQYF	GILGFVFTL
CASGMIAGGLNERFF	GILGFVFTL
CATSDGLAGGWANVLTF	GILGFVFTL
CSASFHNGFWGGTEAFF	LLAILTYYV
CSATSGTDTQYF	KLSHQLVLL
CASSFGGASEAFF	KLSELHAYI
CSVDPDTNYGYTF	NLVPMVATV
CASTTGTVNTEAFF	GILGFVFTL
CASSYGQGSIGELF	ELAGIGILTV
CASSPTGVYNSPLHF	GILGFVFTL
CASSGGGGRGYNEQFF	LIIPFIHLI
CASSSAFYGYTF	NLVPMVATV
CASSYSENEQFF	LLSLFSLWL
CASRWGQGPSYEQYF	GILGFVFTL
CASSPWGQTASSYNEQFF	GILGFVFTL
CASSSLYGDTGELF	NLVPMVATV
CATSRVPSSYNEQFF	GILGFVFTL
CASSPSLGGNQPQHF	NLVPMVATV
CASSTHSGNEQFF	GILGFVFTL
CASSIRSSGELFF	GILGFVFTL
CASGSVPEQYF	KIVALGINAV
CAWSVADTQYF	NLVPMVATV
CASSILSRDRPSTDTQYF	GILGFVFTL
CARSPNGGSSYNEQFF	GILGFVFTL
CSVEDSYYEQYF	NLVPMVATV
CASSTSSTDTQYF	GILGFVFTL
CATSTGWRTGTDTQYF	IMDQVPFSV
CASSPRIGGPREGYTF	VVLSWAPPV
CASQPWFNTGELFF	VVMSWAPPV
CASSPLTGTGHYGYTF	NLVPMVATV
CASTPQGAYEQYF	GILGFVFTL
CASSLMGAEAFF	NLFNRYPAL
CASSSRASYEQYF	GILGFVFTL
CSARDLGGGGDEQFF	NLNCCSVPV
CASSSFVIAGGDYEQNF	VLFGLGFAI
CASSLPGGPRETQYF	ILTGLNYEA
CASSPDRFYEQYF	YMFLASPSV
CSARTGIGPYEQYF	FLTVFSHFM
CASSLVAGATDTQYF	GILGFVFTL
CASSYGTGDGYTF	ELAGIGILTV
CSATTESNQPQHF	NLVPMVATV
CASSSDRGEQFF	VMPFSIVYIV
CASSVVGARTDTQYF	KMVAVFYNT
CASSLAPGATNEKLFF	NLVPMVATV
CSVRLTDYNEQFF	ILNVDIFTL
CASSQDTSGSSYNEQFF	GILGFVFTL
CSVEGEGGSYNEQFF	NLVPMVATV
CASSWGLAGEEQFF	GILGFVFTL
CASWDRGNEQFF	GILGFVFTL
CAWSRVGGYEQYF	GILGFVFTL
CASSLVGGPADTQYF	GILGFVFTL
CASSQSTGANVLTF	GILGFVFTL
CATSRPTDWVETQYF	VLFHRAFLV
CAVRDGTGANNLFF	GILGFVFTL
CASSYPLLYSGANTGELFF	GILGFVFTL
CASSSWTGGNEQYF	VLNYFEPYL
CASSFGQAWETQYF	NLVPMVATV
CASSYRGHLRDYGYTF	GILGFVFTL
CASNPGPTYGYTF	NLNCCSVPV
CASSQALPYEQYF	NLVPMVATV
CSARPTWDTAGEQYF	GILGFVFTL
CSARGAFHEQYF	VLNPFIYML
CASSYFLEQYF	ALSPVIPHI
CASSVRSTDTQYF	GILGFVFTL
CASSLSYTPHQPQHF	SLLLLPVSV
CSSSLRGSNQPQHF	YVLDHLIVV
CASSGPARDTQYF	IMDQVPFSV
CASSTGATGSNNEQFF	LLWNGPMAV
CASSQSGGDVGELFF	NLVPMVATV
CSARDPLDYVRTDTQYF	NLVPMVATV
CASSYGQGYEQYF	NLNCCSVPV
CSAREVRDLYNEQFF	VVLSWAPPV
CASTEGQGGEQYF	AVGSYVYSV
CASSFWGADTQYF	LLWNGPMAV
CASSVSTNYEQYF	KLWASPLHV
CASSPGTGYEQYF	KLWASPLHV
CASSQPGLAGYEQYF	ELAGIGILTV
CASPGGGTYYGYPF	GILGFVFTL
CASSPPPGAVETQYF	GILGFVFTL
CASSIGYYGYTF	GILGFVFTL
CASSLSSYNEQFF	GILGFVFTL
CASSPMNEQFF	LLWNGPMAV
CASSIRSDYEQYF	GILGFVFTL
CASSLSDTQYF	GILGFVFTL
CASSPPTLGQNYEQYF	GILGFVFTL
CASSRRGTGELFF	NLVPMVATV
CASSASGGRDYGYTF	MLYQHLLPL
CSASASLTSGANVLTF	GILGFVFTL
CASTGTANLNTEAFF	GILGFVFTL
CATSSSGAYEQYF	LLWNGPMAV
CASSYSGGNRKNTQNF	GILGFVFTL
CASGGTRPWDEQFF	GILGFVFTL
CASSYSLAGEFF	ILTGLNYEA
CASSSETTSPLHF	NLVPMVATV
CLAGEWYGGSQGNLIF	GILGFVFTL
CSARDPTSGGATGELFF	LLAILPYYV
CASSIRSVYEQYF	GILGFVFTL
CAGANTNAGKSTF	GILGFVFTL
CASSLSGGAGELF	NLVPMVATV
CASSPQTGTIYGYTGF	NLVPMVATV
CASSSLQGNGQPQHF	YVLDHLIVV
CASSIAPSGVAYEQYF	LLWNGPMAV
CASREGEYYGYTF	NLVPMVATV
CSVRTGTRSFSGELFF	NLVPMVATV
CASSAGTGAYEQYF	LLWNGPMAV
CASSIRVSGANVLTF	SLLWMNLFV
CASSALQGPSQPQHF	GILGFVFTL
CASSYARDRNTEAFF	MLSILALVRV
CSVGEGLAYEQYF	LLWNGPMAV
CASSFGIGPQYF	FLYNPLTRV
CAISPGGEQFF	KLVALGINAV
CASSLDFQGPRDF	LLAMTVPNV
CASSQGAAYEQYF	LLWNGPMAV
CSARDLGLHQPQHF	SLPITVYYA
CASSLWGAGELFF	VLFGLGFAI
CASSYSLAGTSYEQYF	GILGFVFTL
CASSFSPSSYNEQFF	GILGFVFTL
CASGPLLLMTNEQFF	NLVPMVATV
CSAWDRTEAFF	GILGFVFTL
CAAEDDTGGFKTIF	GILGFVFTL
CSPPKDLPYKRNF	GILGFVFTL
CASSFNDEQF	ELAGIGILTV
CASSYGLNTEAFF	GILGFVFTL
CASSLGGFAGNTIYF	KLSHQLVLL
CASSLTTPPSTDPQYF	ELAGIGILTV
CAEGQGFVGQPQHF	ELAGIGILTV
CASGFTFQGSPEAFF	IMDQVPFSV
CASSYYSGQGNEKLFF	KLVALGINAV
CASSYSNGGYGYTF	NLNCCSVPV
CASSFGLAGVEDTQYF	NLVPMVATV
CASSKRSNPPQHF	GILGFVFTL
CASSFLLYNEQFF	TMAAISNTV
CASSQMTGLNTEAFF	GILGFVFTL
CASNQPQHF	MLNIPSINV
CASSIVGNTEAFF	YVLDHLIVV
CASSMRSSYEQYF	GILGFVFTL
CASSATGADQPQHF	ELAGIGILTV
CSVVGTGSVITNEKLFF	ALIHHNTYL
CASDPLTASYEQYF	NLVPMVATV
CAISELGYEQYF	VVLSWAPPV
CASSPAAGGAYEQYF	LLWNGPMAV
CASSYGDLYTGELF	ELAGIGILTV
CASSQDRWDVMSQNIQYF	VLFGLGFAI
CASSVRSTGGLF	GILGFVFTL
CASSEGQGRWYEQYF	ILTGLNYEV
CASSGFSNQPQHF	MMPFSIVYI
CASSWGPGYEQYF	VVLSWAPPV
CASSARSTDTQYF	GILGFVFTL
CASSFYGYSNQPQHF	NLVPMVATV
CATSRESGNGKLFF	LLWNGPMAV
CASSPGLYTQYF	FLYNPLTRV
CASREGTEAIDTEAFF	VLFHRAFLV
CASSLGGDEQYF	NLFNRYPAL
CASSPGTSYEQYF	ALYGSVPVL
CAVTRNPGDSNYQLIW	GILGFVFTL
CASYATGTAYGYTF	NLVPMVATV
CASSVQGYTEAF	NLVPMVATV
CASSDLDSNQPQHF	GILGFVFTL
CASSQGVIESGELFF	GILGFVFTL
CATDPGEGNTIYF	GILGFVFTL
CASSLGGGAGEQETQYF	GILGFVFTL
CASSLMADTQYF	GILGFVFTL
CASSTRSSYEQYF	GILGFVFTL
CASSSGLAGGPKHYEQYF	VVLSWAPPV
CASSLLVSGVSSTDTQYF	GILGFVFTL
CASSWIPGGSEAFF	NLVPMVATV
CASSIGHYGYTF	GILGFVFTL
CASSSGWGVGAFF	NLVPMVATV
CAWSGLSGSYNEQF	YVLDHLIVV
CASSARGYDEQFF	ILTGLNYEV
CASSRRSSDEQYF	GILGFVFTL
CASSEWAGQPQHF	VVLSWAPPV
CASSILTGPQPQHF	GILGFVFTL
CASSPRQGIETQYF	GILGFVFTL
CAWIITSTDTQYF	NLVPMVATV
CASTSYTEAFF	GLYDGMEHL
CASSTLAGVHYNEQF	NLVPMVATV
CASSQGLGREGASEQFF	NLVPMVATV
CASSLGSGTQYF	KLVALGINAV
CASSLEGETQYF	GILGFVFTL
CASSPRGNYGYTF	NLVPMVATV
CASSLGTNANTGELFF	NLVPMVATV
CASTLTGLGQPQHF	ELAGIGILTV
CASSGELTDTQYF	VLNYFEPYL
CASSVADRGFADTQYF	GILGFVFTL
CASSTRSTDTQYF	GILGFVFTL
CASSEGWVDTQYF	VLFHRAFLV
CASSSGSPGSYGYTF	LLWNGPMAV
CASSKPSGGINEQF	ELAGIGILTV
CASSHPNPGLATGELFF	GILGFVFTL
CASSYSRQWNTEAFF	NLVPMVATV
CASSSTGDFSYEQYF	NLVPMVATV
CASSAGGTEAFF	KMVAVFYTT
CSADRPGQSQETQYF	FIYQYYSSI
CASSSDRGLTYNQPQHF	NLVPMVATV
CASSLNRGPADTQYF	GILGFVFTL
CASNPGRGNQPQHF	GILGFVFTL
CASLRSAVWADTQYF	ELAGIGILTV
CASSVSGSGTGELFF	KMVAVFYNT
CASSVASGRAHEQYF	NLVPMVATV
CASSEDHTGFYEQYF	NLVPMVATV
CATGRGGKIGEQYF	NLVPMVATV
CSAPPDSLNTEAFF	NLVPMVATV
CASSLLLARETQYF	GILGFVFTL
CASSGQGTDTQYF	ALYGFVPVL
CASSSGSSYNEQFF	GILGFVFTL
CASSQEVVANNEQFF	ELAGIGILTV
CASSTRSQETQYF	GILGFVFTL
CSAGEASGVFQETQYF	NLVPMVATV
CASSQEIGMNEKLFF	KLSHQLVLL
CASSPAGAYGYTF	LLWNGPMAV
CASSPGQVSYEQYF	LLWNGPMAV
CASSQTGNQPQHF	NLVPMVATV
CASSQDLAGEGTDTQYF	GILGFVFTL
CASSVGGFGNQPQHF	ELAGIGILTV
CASSEELYNEFF	LLLNMLIVL
CASSAQTGASYGYTF	NLVPMVATV
CASSIRSAGRAFF	GILGFVFTL
CASSLGTGALEQYF	NLVPMVATV
CASNPGTDFNTGELFF	MLSILALVRV
CASSVSQGGYEQYF	NLNCCSVPV
CASSQGQGYYEQYF	GILGFVFTL
CASSQGSGQPQHF	ELAGIGILTV
CSAPTSGGSNEQFF	LLWNGPMAV
CASSEISSGGPFLDTQYF	ALYGFVPVL
CASSLEGETQYF	NLVPMVATV
CASTTGLAVMEQYF	NLVPMVATV
CASSYPSRTGTSRDEQFF	GILGFVFTL
CASSVQSTDTQYF	RLVPYLEFL
CASSDSRGTEAFF	LLWNGPMAV
CASGTEIFYYEQYF	LLWNGPMAV
CASSFAGTTEAFF	ELAGIGILTV
CASSYGLEQYF	YLWPPVQLA
CASSADGILNTEAF	GILGFVFTL
CASSLGPAYEQYF	NLVPMVATV
CASSYRRPSGILYEQYF	GILGFVFTL
CASNGGSYEQYF	ELAGIGILTV
CATSGTGGTGELFF	LLFALHFSA
CASSHDAGASTGELFF	LLWNGPMAV
CASSGQGGYEQYF	LLWNGPMAV
CASSRTGSLNYGYTF	FLTVFSHFM
RASSPRTGGEQYF	RLGPYLEFL
CASSTLIGSGNTIYF	FLTVFSHFM
CASSIQGRGDTEAFF	LLWNGPMAV
CSARAGAETQYF	ELAGIGILTV
CAWSGGTSRGAQYF	GILGFVFTL
CASSVGGVPYNEQFF	LLWNGPMAV
CASSQEEGPGNQPQHF	NLVPMVATV
CASSLSGSSYEQYF	LLWNGPMAV
CASSYSGHNEQFF	ALSPVIPHI
CASSGRQGIDTEAFF	YMFLASPSV
CAISRGDTEAFF	KLPLDIDPV
CASSPREFYNSPLHF	GILGFVFTL
CASSIRGSGEQYF	GILGFVFTL
CASSYASGGYEQYF	NLNCCSVPV
CASSVDVSNEQFF	GILGFVFTL
CASSLGGLTDTQYF	VVLSWAPPV
CATHGVSSRETQYF	IMDQVPFSV
CATQGDNTYEQYF	GILGFVFTL
CASSLKTDSTPLQETQYF	RLVPYLEFL
CASSLAGADNEQFF	ILTGLNYEV
CASSLLGLIKETQYF	YMLDLQPETT
CASSVGGGSSYEQYF	ILTGLNYEV
CASSQQGLGTEAF	ELAGIGILTV
CASSYQHEQYF	GILGFVFTL
CASSYRGGAGELFF	GILGFVFTL
CASSEDPATNEKLFF	GILGFVFTL
CASSSVGGSYEQYF	FMLYLLTLM
CASSQDRGNEQFF	FLIYLDVSV
CASSLERLRVYSGYTF	LLGATCMFV
CASSFKGADTQYF	NLVPMVATV
CASSPGQGAFSYTF	ELAGIGILTV
CVVSLNNAGNMLTF	GILGFVFTL
CASSQGWGVETQYF	RLVPYLEFL
CASSRGGHEQYF	NLNCCSVPV
CASSIYGAGYTEAFF	GILGFVFTL
CATSRGDTGELFF	NLVPMVATV
CASSLATEQFF	AVGSYVYSV
CSAPASGGGNEQFF	LLWNGPMAV
CSADVGGQNEQYF	KLMNIQQQL
CSVVAGGADTQYF	NLVPMVATV
CASRIGIYGYPF	GILGFVFTL
CASSQTTGDFGYTF	GILGFVFTL
CASSIGLNQPQHF	KIVALGINAV
CASRSGSLNTEAF	ELAGIGILTV
CASLSGGGEQF	NLVPMVATV
CASSFTGPGELFF	GILGFVFTL
CASSLARRTGGVYNEQF	NLVPMVATV
CASSRGGLTDTQYF	RLGPYLEFL
CASSLAQGWGAFF	ELAGIGILTV
CSASEAGGSYEQYF	LLWNGPMAV
CASSYLTSGIYGEQFF	GILGFVFTL
CASSPGGTNEKLFF	LIFNMFYWI
CASSQFRGGRDGYTF	GILGFVFTL
CASSLPTSGEETQYF	GILGFVFTL
CASSNSYEQYF	ELAGIGILTV
CASSLVGDRDGYTF	NLVPMVATV
CASSTRTGTGNTGELFF	GILGFVFTL
CASSDGQPQHF	GILGFVFTL
CASSIAAGNTIYF	KLVALGINAV
CSVRTPSSYEQYF	NLNCCSVPV
CASSPGPTSYEQYF	LLWNGPMAV
CASSTYYEQFF	FMLYLLTLM
CATRKSYNSPLHF	LLFGYPVYV
CASTGTGGFSYNEQFF	LLWNGPMAV
CATSGTGGSGANVLTF	GILGFVFTL
CASSHGQGGQETQYF	GILGFVFTL
CASSLISEATGLEAFF	RLVPYLEFL
CASSPRSGNEQFF	GILGFVFTL
CASSTYANTEAFF	GILGFVFTL
CASSYRSTQPQHF	GILGFVFTL
CASSCQTGAACGYTF	NLVPMVATV
CASSYSTEAYEQYF	LLWNGPMAV
CATSDPLIKGLAEYNEQFF	VLFGLGFAI
CASSSSGGLDTQYF	KMVAVFYTT
CASSIVSIAGELFF	GILGFVFTL
CASSQALPYGQYF	NLVPMVATV
CASSEDAGNYGYTF	FMLLTQARI
CASSTGTAAYEQYF	LLWNGPMAV
CASSPQGAYGYTF	LLWNGPMAV
CATWDSGNIQYF	KVAELVHFL
CSARDGPGDPYEQYF	GILGFVFTL
CASSQGVSGVYEQYF	GILGFVFTL
CASSWGGYTF	VLNYFKPYL
CASSSPGGRGNTEAF	YVLDHLIVV
CASKSNTEAFF	GLTSFFIAI
CSVRVGTQYF	FSSEVLNLV
CATSSGTGAYEQYF	LLWNGPMAV
CSATRGGRTDTQYF	GILGFVFTL
CASSCAGGPRDEQYF	NLVPMVATV
CASSEGGIGELFF	ELAGIGILTV
CASSLAENSGNTIYF	FLWSVFMLI
CASSHPGHIGQPQHF	GILGFVFTL
CASSSRQGPTGELFF	GILGFVFTL
CASSYSGPAAGQETQYF	GILGFVFTL
CASSRVGTTYEQYF	GILGFVFTL
CASSLFAGGPVEQYF	GILGFVFTL
CASSIGTYGYTF	GILGFVFTL
CASSLQASGRETQYF	KLVALGINAV
CSALSDEQYF	GILGFVFTL
CASNQGPGNTIYF	ELAGIGILTV
CASSEQGGERRNTEAFF	LMFWASSSI
CASGSGLAGGELF	NLVPMVATV
CASSAQGDSYEQYF	LLWNGPMAV
CASSPRQSNQPQHF	NLVPMVATV
CAISEMLIRGLANYGYPF	VLFGLGFAI
CASSLGTSSTDTQYF	VLNYFKPYL
CASTQPVDMNTEAFF	SVLENFTIFL
CASSLGPNSPLHF	ILNAMIAKI
CASRPDGRETQYF	NLVPMVATV
CASSIRAAETQYF	GILGFVFTL
CATSRTDISYEQYF	FILDAVQRV
CASLGGGYPF	GILGFVFTL
CASSQLGGISNQPQHF	GILGFVFTL
CASSRRSTGELFF	GILGFVFTL
CATGPPPQDGSYEQYF	MMPFSIVYIV
CASSFLGDEQFF	NLNCCSVPV
CASSKRSGIEQYF	GILGFVFTL
CASSHTDYSNQPQHF	GILGFVFTL
CASSTPGGWNTEAFF	VQYLGMFPV
CASSPRTSGPYNEQFF	GILGFVFTL
CASSTSSGNTIYF	GILGFVFTL
CSARQTSGGSSYNEQFF	FLDEFMEAV
CASSYASTGTLNYGYTF	FLYNLLTRV
CASTVDSLDTEAF	NLVPMVATV
CASSLEDSANYGYTF	KLWASPLHV
CASSPLALYFNEQF	GILGFVFTL
CASSNDNQPQHF	GILGFVFTL
CASSPTGSYGYTF	ILNAMIAKI
CASSLGAYSGANVLTF	GILGFVFTL
CALSDLGGSGNTGKLIF	LLWNGPMAV
CASSGGGAEAFF	ILTGLNYEA
CASSFYGREAFF	LLWNGPMAV
CASSPSAGPGYGYTF	LLWNGPMAV
CASRDTSGTAYEQYF	NLVPMVATV
CASGGDAYEQYF	LMVPHSPSL
CASVGPGYTGELFF	GILGFVFTL
CASSESTGVEKLFF	GILGFVFTL
CASRLAGSHEQYF	GILGFVFTL
CASSHLFLPISDGGLLRANVLTF	GILGFVFTL
CASSMRAGYEQYF	GILGFVFTL
CASSQDWGNEQFF	LLFGMTPCL
CSVGGTLDTQYF	NLVPMVATV
CASSISSINEQFF	GILGFVFTL
CASSEGAAIGPQHF	GILGFVFTL
CASSKQTGTGNYGYTF	GILGFVFTL
CASSIRSGNIQYF	GILGFVFTL
CASSVEGSGETQYF	AVGSYVYSV
CSVAGTVNEQFF	NLVPMVATV
CASCSTSFNEQFF	GILGFVFTL
CSALGLAGGQGGELFF	NLNCCSVPV
CASSVEGSSYNEQFF	LMFWASSSI
CASSQDKGGSNQPQHF	GILGFVFTL
CASTPSPSRPPLF	LLWNGPMAV
CSVVSGKGLNTEAFF	GILGFVFTL
CASSPLLGGHQPQHF	GILGFVFTL
CASSLRSNTEAFF	GILGFVFTL
CASSVVGGGAANEQFF	GILGFVFTL
CASSSSGRDYEQYF	NLVPMVATV
CASSADRTQNYGYTF	KMVAVFYTT
CATSDTHSGANVLTF	GILGFVFTL
CAWSVLTDSPLHF	GILGFVFTL
CASYVGLNTEAFF	RLVPYLEFL
CASSLIAGGNNEQFF	GILGFVFTL
CASSSYLQDRGTGELFF	GILGFVFTL
CASTQGDTGELFF	ELAGIGILTV
CASSLAESVYEQYF	GILGFVFTL
CASGSYEQYF	LLAIKVPNV
CASSLGPNTGELFF	NLVPMVATV
CASSMAAGTHEQYF	ALSPVIPHI
CASGPNFNTGELFF	GILGFVFTL
CAITSGFSYEQYF	RLHDLVFPL
CATSDPLTASYEQF	NLVPMVATV
CASSTLTGGHQPQHF	GILGFVFTL
CASSSVSGGAFNEQYF	GILGFVFTL
CASGTWGARQPQHF	LLWNGPMAV
CASSLRPLDMNTEAF	NLVPMVATV
CASRDSLTGELFF	VVMSWAPPV
CASSIFGGAEAFF	GILGFVFTL
CAWTPGAPGPTDTQYF	GILGFVFTL
CASSLETGGWETQYF	KLNTITAVV
CSALTGLGNYGYTF	SLLWMNPFV
CASSFRSANEQF	GILGFVFTL
CASRRGQGLSNQPQHF	GILGFVFTL
CASRQTGAAYGYTF	NLVPMVATV
CSASRQSNQPQHF	NLVPMVATV
CASSDMAGDGYTF	ELAGIGILTV
CASSFGGLYGYTF	KMVAVFYNT
CASSSAGAAYEQYF	LLWNGPMAV
CASSLAPGATNEKLF	NLVPMVATV
CASSLVRDRHTEAFF	LLAILTYYV
CASSSRSGYEQYF	GILGFVFTL
CASSETGATNYGYTGF	NLVPMVATV
CASSLSGSGDEQF	ELAGIGILTV
CASGGGGPETQYF	GILGFVFTL
CASDEKLFF	KLSEGDLLA
CASSLSWLDSQETQYF	KMVAVFYTT
CASSGRSADTQYF	GILGFVFTL
CASSIRASYEQYF	GILGFVFTL
CASSLAGQVFSGELFF	ELAGIGILTV
CSAAYNTFGEQFF	FLYNLLTRV
CAISRGNEQYF	GILGFVFTL
CAVRDLNTGFQKLVF	GILGFVFTL
CASSITFSDTQYF	LLAILPYYV
CASGGTGPWNEQFF	GILGFVFTL
CASSYSNGYEQYF	ILNAMIAKI
CSVRGGGDNSPLHF	VVLSWAPPV
CAISEGAAYGYTF	LLWNGPMAV
CASSLVSGREETQYF	KMVAVFYTT
CASSVGSGEQYF	KMVAVFYNT
CASRLGLGYEQYF	NLVPMVATV
CASSLEGYTEAFF	NLVPMVATV
CASSSGTSLTLTYNEQFF	KLVALGINAV
CSARLTGGSGQPQHF	GILGFVFTL
CASSQARPYEQYF	NLVPMVATV
CATSRGTGAGEQYF	RLGPYLEFL
CASSLSWEYEQYF	LMMPFSIVYI
CASSLWGQGWTGELFF	FLTYLDVSV
